Account,8329 Era,8339 Era,8357 Era,8391 Era,8396 Era,Total
5DhkXVhY59Ph3DTjPvMSZF8T5d5QRbWK49LFDMCckMUYsG42,658,8161,8041,4508,5144,26512
5DfmbaBJ2JkzAbf94nQPzfNsdeGXpF3gKTAqM5QxBJZT4zjn,3619,31551,44265,16691,18906,115032
5EDFXFbv51Qda3xrqaze3n5oZCHfgTkLTMj8zSVMiw3mgPjn,810,10053,9905,5553,6336,32657
5HBozvVcPhvSvMgJX3y8zUFjf892iLhCcdeGr82EhsKgFFo8,468,0,5720,0,0,6188
5CqL5vB4u2zm9VzMQGprzSMj6Ld8vfEgUuTj39q3EZtujsWs,32050,397947,392089,219811,250807,1292704
5Ec3R3UD7RTALFy5obnrGNARjrCesaii699GBHMWtoDS1YhZ,598,0,0,0,0,598
5FsZHDCJhiCX4Zw6rcZfsqZL7ards2389z4u8AnhRDSjWt1m,158721,1970743,1941732,1088565,1242063,6401824
5GRQGTHjbbV6URXDoyFsADu3Ma1hcekaCKK86ERZnLgEPAT7,652,8086,7967,4467,5097,26269
5EUG4Cdn5NVnZBxLhLVgqyZezHhsihxjaTWSSTMyBpkUCenU,916,11370,11203,6281,7166,36936
5DXhp17zuTL8EJvYpYZy1LexBRjBme2LqtJth4q8NRjdSzQ1,4579,56850,56013,31402,35830,184674
5FtC3AKAFS3SqhEUjSGXag46sVErs3e32XeqRtrWSimkA5Pg,465,0,5688,0,0,6153
5C831Js8xLcZpjKMqFA9H8oQP3FKtvYukymUwEwwJFs2Uwm8,5495,68220,67216,0,0,140931
5G27oms6XpMZ5em9JT2BcerYLHhR9hMyjwf2xrDqYnDSkrHz,770,9561,9420,5281,6026,31058
5GuchGEStk26b8XdSmqH1CbQTVFQNk1aTp5wyRVvutgqRg1e,649,0,7935,4449,5076,18109
5EWe8xWXBAk4dAom1zhsXkNSE9FZq6woxWBshLCMGf9BAUyS,8868,110099,108479,60815,69390,357651
5HYow1Mzhm91iBGQPA75J2tmvDHKZcKzEpwbBKPQtWKNpT2Q,1072,259804,124841,150542,227651,763910
5HDkqkvSoKvFmNFzMSQN7611p1mNPDknnhjJDiePZv7gQqXv,1505,18675,18400,0,0,38580
5FWkamfFkRgiJcu3CLeDEq8zoadxRctLdt6tFbRLVCdVjHLq,17457,216746,213556,119723,136605,704087
5CZem6XsW7Dqvby5dz1EBtwQ6XWBcB1T2JpZGQvWcXqDng1T,2290,28425,28007,15701,17915,92338
5FzzfW5VYaUCb6deYVGDKEqqrUoBaH7dMuGV3uwAGHKbCxMb,6283,78008,76860,43089,0,204240
5CA6BoQEwSTYCz2vXWUSaX294dPaJR5iKi6XMrDuBx8nK1gB,11974,148672,146484,82121,93701,482952
5DyYa5h6wvsWkTo5Ewi32ziimYH2jv7NtsNcimV4j2tPAcJy,494,0,6036,0,0,6530
5GRBok6NgqCekLpSm6ujuHautEkSnTMp5tgpLfsgXxQj3a8T,2582,32056,31584,17707,20203,104132
5GH2Bmg6ZL1FjE41QBzs9HEJVdjVYQheUTS9CastwgGXHyKQ,4675,58036,57182,32057,36577,188527
5CLthFJN3FgEw8GYv8DnJS5YJTCbfZ6oPpxfnYZrc5HE1Qkq,6189,76844,75713,42446,48431,249623
5Fzs3aXgh7YVgvfpjkgbhfeRZDpbHNT4jbPhYT2vAjoGt9NK,3342,41494,40883,22920,26152,134791
5GgPKAhrNfvqF45jbS8eFse52CbZYVjC6yc8bEmSvNaKTowu,4579,37733,56013,16721,18688,133734
5FZBgnGwYrBAkAAsfY6YgYVvDRizMYUUb4fZDDJsbCh83qkA,7449,92479,91118,51082,58285,300413
5F6iVFfo2d5Mt7MKkQNkwHozCTg9RVG1R3Awn7GewusDcPc2,5830,72385,71319,39983,45621,235138
5Dev5dLekekY7dp3DFAmbyhjaFTtzfrTWUqGNYKDx1AMDr8m,5410,67170,66181,37102,42334,218197
5HdcHtgWBYFbE6YHH9kNA8n83zrDAPG6fg6JRXhMBs2wmMkq,458,0,5602,77894,0,83954
5C7sYeSqKtJTaniXCYyobxppnnC8yupesZ48RrfhRVTkxwWa,4579,37733,56013,16721,18688,133734
5EU2GEjekexMfnvqXyaFBpvxXU2WH4eL8YoWcJdeS51jcP2S,672,8335,8212,4604,5253,27076
5FpUHQbgL57mde7WWZmAPB4s9nsPbyisHkuRDaYSNTCT3S3X,22893,284248,280064,157008,179148,923361
5EjimGLr6N5pGtHn1d961SqtNwWhfGuQbxfpBj9awUiJmnrZ,4552,91764,63985,38426,45020,243747
5FCimx5ss2iVBr4yPKSx5V16PEX4CM5zJGC2gQM6vdeC6crM,6653,82604,81388,45628,52061,268334
5FLY8hX8jom6hthiyi8bEzcRrVz6x1iaJK3A7HvhGfCr6vpc,2290,28425,28007,15701,17915,92338
5HC9gdLgq5YE8wZZU2cbwGAqV2aeXz5UqLuWKKhQ8HQZwv4d,504,46744,32357,56174,69421,205200
5Ew7cW4tUbj3Caoj8Jk2tPjmRRKp8WfcQ7eofvdJAeBQCXyd,4580,1610205,868835,0,0,2483620
5DkVDGGKYkiWR5jg3pws3ZHrD75k4mgTvnmMbb9nMaYAY86C,1638,20338,20039,11234,12819,66068
5EFYmDxjwExaBhSdGJsyfRmiqQ2B4ygKMj9JmTbRdXUNXdJA,916,11370,11203,6281,7166,36936
5Eqcnd11EKkp73enEDaqy9Mz8GVy1oCUuTxjPxKqTLaEtZYN,2232,27704,27296,15303,17461,89996
5HKmKxHLQb1YPJRQkRJD7FcLFSQRQps26CPddDoH4yGSJtpQ,764,9475,9336,0,0,19575
5GsgnUyQQwuE8M5wTCw1zqaCUbDfzbkq3M31biSdejyrF4ya,550,0,6722,3769,4300,15341
5H3HwiNA2Z1PLwkKSevGqNmzYS4rt1jtxU4LcBQ1dRhQKpNR,4157,51612,50852,28509,32529,167659
5HSsRUqU7kmE4Hd4rE4ddbRAwnuLgcFbnq4zKM11F45kRVx3,458,0,5602,0,0,6060
5HThwJqXqhSXwuQdAg9sYjgVtUVM8qb9faqkC4knse4XMVNF,3346,41540,40928,22945,26181,134940
5H6e5BEvsZtyQRAw4jkCrjx22c8F2tucSfHaV6xB9GCAP1qp,9616,119388,117630,65946,75245,387825
5ECexjXggDkeoe7j5kWQQEELUsNbe5CuQhASMNxSE9DVYxTe,1389,17238,16985,9522,10865,55999
5Chtth119MsVWh8WhDcDXrCAZd51hSASrWXdE5XfZDpqhhrZ,3434,1388263,562086,606965,759168,3319916
5HEwY38ET2DDpZhiesRGjhZeBgNpnW5LP9tMcefxWhTyurNn,5898,73223,72145,40446,46149,237861
5G4Km8G8QcQsHsWznYDgiVRp9vxh2T6avGJ2UowHgyfybKsJ,3125,38791,38220,21427,24448,126011
5GMukHxUM4q4ty24Af1vLCiZZgNX16xkvN2LNnaZRkH73A31,458,0,5602,0,0,6060
5CJuconMyQR5idzwFJVVRKUgdSjt2YNA4oavnwZm7rCm85MB,21173,262885,259015,145208,165684,853965
5HBRdSr5taPkfwrmaqMNGDWvV7MkDzQ7NxPknTRYPZKSDNCP,1092,13549,13350,7484,8540,44015
5G6UJgYtLAcAP3vARZvV14ia6ZJk3b9h6jGB3EN3PmXSMVgu,20772,257911,254114,142460,162549,837806
5DFzLBqPkqRfHRHLrNCEzckQ1os1bpbWBYFCvLwR1SvXd9Hc,14066,174633,160859,0,0,349558
5H1hu9oyxjKjRnFvL2sKEuAC4dZSQJANiiTT7tL5GTcnvgYr,458,0,5602,0,0,6060
5EWyv6ncbRzyrWzaGA1WGGNunzfBE5VhD3GhC9AvfAEnMCdk,1391,17269,17014,9539,10884,56097
5GBaF2X73Xuh7wuPmn8xv1axrMTjjSBXgceKWguNXzMhDo8C,822,0,10048,0,0,10870
5GxM9Y83jVs4DWTFxgViWaU9B3rhnnqiJ6Ep7takxcUKg1XY,504,0,6162,0,3942,10608
5GHjRPC4R6UzbPVEDXCKwF6zCZ2rh6e3ZtW6GHcguKVAuwbC,588,0,7192,4032,4601,16413
5DUTbAHBNtgMqMbYigLBbaRJd7nEpcm3vThPxk9wjMhouNu2,1210,15024,14803,8299,9469,48805
5E75AHGv86kYRZQKrDJ1MntKDNj7cu72c9zDaJJEYiq1bYQg,458,0,5602,0,0,6060
5G1pFPhc269hhbHzhZtExyeN4Y7mBsoGYbcJZekkVrtwGu37,2628,32623,32143,0,0,67394
5GroNoasoq9kPQxXFTte4JpFVg8YgtYFxv3mMTJhaGboAuBJ,461,0,5630,0,0,6091
5C53KrC7KUzrXHd1gKmUAsCaKADsUn7HSQ7h1jBRuveAi7r5,25815,320522,315804,0,0,662141
5EXUkbQhtqPu4azqd7VtQm23d1jGGEWVJuQ6BwzYUfph123M,2075,25764,25384,14231,16238,83692
5CV1VP8oKfQwAnquv4DLMEH1PGvt5C8MrCaVyBXtE3BMWv8P,274715,3410974,3360763,1884095,2149771,11080318
5G1g6cZ6pbjxtzaw5hAEDPedK1Bfnbc4MDUMmkSAUs7rYx4i,458,0,5602,0,0,6060
5Evjn2XxYpUf7Lz1zRkazohaYjUEe7L8w6cJ1ZDEQmdvZnYC,8546,156736,118304,65066,83590,432242
5GgLE8GLPAvekpZvFrGjGeWcAh8VwsFnmEDGosetD7CSq7H5,2145231,53398899,37375867,20939464,26308881,140168342
5CFNYab6UKkZJ87WpW3WVbG8huwpKczvCYpZyrwH37uFj2QM,367249,7662618,5347583,4079500,4592224,22049174
5HR5M6puiW61pzzRzQw33sVmTsTU4GVGjx6YTKRuGm1ycHUZ,1625,69212,79531,45333,61132,256833
5EjxFYZaJiq9R1aFGhMQo4hNHAAp3nsn33YfpHDhubVCCbea,33641,1704379,1639736,947875,1273456,5599087
5CAUKPRqbZ4hXJDKkv3haHVVbTAaTVs6ApFAT527tQY8fZe4,5927,379484,290111,198708,261297,1135527
5Cm3ABhuJ8bUB1nEhDXH2N8sTJwV47S4K76dLaronj9nJskS,4315,0,0,0,0,4315
5EZBG4asvtpPrjWRXCVfvn4p6rRnrqc3ti9mF4BzdF9gHtyx,8715,319412,426569,215281,301463,1271440
5F7N5ZB5pWdLHxu3KucBcSa9vQRt2SBSxUrNJ1gHcUKXRfwA,2533,91045,123961,62282,87605,367426
5DfKdBnh8es8aAYvHLFVzTcFRw9pLK8A3CMC193tX2jTfQkJ,22346,1430718,1093767,749163,985131,4281125
5FC4a3ZRWdAeisSzxu1VW2puuwo761FPY4viqhBZmXfq7R1w,19366,630115,947931,0,0,1597412
5CRwqWZL1CwiL2XXYibL94jHsoBcckVa8aQfqrrgT18m2Fjk,1698,61644,82749,43900,0,189991
5FLb1rVaiErgG7rXPMwkV4VprUNDTZwSAUwkKQvq7ZL8tYaV,30550,1261369,1489088,789999,1095848,4666854
5CJ91MgjabAnR77KbWFSRdcYCKksHo9d9TUqHT9Xd825QXAP,1937,123996,94794,64928,85379,371034
5GbtjQQiSw3ZqwuFRzXy7bgF9K9JCf6vPyY7wZv49JnDkzmk,1594,52134,77651,36703,52335,220417
5FLei1RQ89R8firpawoASyfHmm4xd7KxD1uAgRTT5PtvqydK,17285,767074,842510,473329,646132,2746330
5CJHAxVGwuxwHiKAS2ZdGefYpxwK6vntibqr4KfkcZqyJL4J,2477,130549,121239,72383,97970,424618
5HHGdedxBSS4WAw4oExWok8ZJ21FJBUDj9jfnWsNSHoSYd2Q,3746,0,0,0,0,3746
5CoaVLQv9NHHacn23tD3BVLPMn4B3rrvV21SLcooe7kRZNse,2387,99796,116797,4171,4869,228020
5CFWw7qooDg37TpPp7a7nZyRigf4NPL5rKLxDoerVnmkPQ93,7359,372834,358694,207349,278570,1224806
5DkSYadFYJ7FfT3mTEE2zo9J9A1x14jEfbztr8QwyJv7RmK7,35025,1774517,1707215,986882,0,4503639
5G4RW552iZVYsMwYG1xXhq68zqmNFizh889Qq2nG8gNz3KQB,29262,756318,1426286,564725,964751,3741342
5GbupRzeT2N58fjLdsKf7VzgqvUST53eNm58Kc2zKFKU73G5,14883,500809,725429,377093,524850,2143064
5HZH3c2kBQdDRCpePMqpe27MM4xfxtM4KrikRhGAodfeVsKz,1490,95382,72918,49945,65676,285411
5Fk7QMSMWQo7cTiGtAGQQf59zqFuxf3ay3tshnrhPLCjm727,10282,0,0,0,0,10282
5GC5xhGLPAQnqBMY8MuhBTqLPKu52tyGC2ZazfKsKpzMJFbj,1507,96469,73750,50514,66425,288665
5F1vrgUBG8PeyycMDrFVzhTALd2xMwiFRCcp7TWz9cHzZJ5h,12703,767042,621766,410970,544439,2356920
5EC46nE76wR5heiLiJLvtmSq5GMDbyonmf6aZDdEzSgUmHfz,2980,190763,145836,99889,131351,570819
5En6YFthMK4Neo4wk8iRtsgrqnXH6Aru57hWRDQnBR6UmYwo,28412,1431926,1390684,0,0,2851022
5H6RMaTtoupHL4yfn7VHn5UHgWy5kQ8YvRpST93YiZwaVJQk,764261,57384606,35955170,0,0,94104037
5DNr4Tpi8UnMAQd9fCTbcQStqvrjXvsdd2jVFGvSP9M9ijAk,142678,5324356,3633436,2293818,2670404,14064692
5FgyR7t4xBTn4H6H8JV9XNT4ozkvk3XDf1B7FZWAfEdRfAMh,430,0,7474,0,0,7904
5HE4gbF9xqtxfPgF1chztmR4teoG6fJ3N4p3j2aPZXAdDfDW,1484,0,0,0,0,1484
5DFbmUeACHiGxLbgTusNAJqZ32UfdSuHSxwv3MBvPs7SdqJ9,25482,664900,501864,276019,354603,1822868
5DAkrxuHaXHqC81sJzuNhuZQkw9KDCQqESqCqbRy4hoz3VEt,418,0,7265,6663,15389,29735
5GpNbB46zPJKFkHsUo5zXg1xEcdccUMwfmPPTXBdJsffWugw,2302,57225,45324,25067,29126,159044
5Hj5UUAtfAus3ATCTmMzTi7LxF1jPG86dMPTremsPSByPbmu,322,0,5602,0,0,5924
5HQRrSJBhCSKR15wTYDatnDvjZHzAQi68UaGonBkpTgg3EoB,4200,90035,89610,38801,48956,271602
5FTVDHunHzkJz3ygCnNCp1sjMkK8WdHDiHcX6YjHin6i1Ykq,16093,5709771,3866186,3641097,4410479,17643626
5DAL6Xmra1nW5m51LFuo39igBawU4FtRzMsPitZj9jEtKX7Y,665,7732,13079,5043,6797,33316
5GRaMYGitoRn5uhcJ4pWbFAcPKmj3PJVS9psgJArcvgqUNRb,1065,22394,20964,8084,14813,67320
5CZrstxUPYZrUALRZUFB9m158tqW1xLeKDZgfrAyED4xBX5b,4474,135505,95461,63480,76637,375557
5HpzSHMMw12Qjdd3inskFTsmuiXPudmt53pmUcq44WsHjHFh,3219,143176,68677,60628,74351,350051
5CvmQ78CpitNy8QV7gSj7eT6cUoNXb1NkSoAxGTQyq3SrPTv,2253,0,0,0,0,2253
5D5CjEKGT7ue87TQMc8Gf5F4XawtjXEBSUUK59J6bcgQ56E7,51495,1414757,1014215,554773,697031,3732271
5DkCLqCBVMRa3hHdKMw8VysuV4Z7YMjbCsbPF6xJFPzdLYAM,869,18271,17104,6595,8889,51728
5GqBfUUoNHZ2xQQLsAinnWfWFZZWb2nAPZY2DBcaSSJrf1Uv,1384,29118,27258,14992,19260,92012
5EyA2ZPkvvYgpAVnz8seJNZy4fdwEYR1dcpFNWxPki9A46KQ,2483,31678,52976,10688,14269,112094
5HWRFJdgoBtnn5QLy1Ydqg9jjqbcm39rc85T8Le3PQGyAN3J,6444,180361,0,0,0,186805
5DWsPW9FuzPfReH72AY6R2WHbsj7PcVKPsteXPdVbzPmPYoe,417,0,8878,0,0,9295
5Cov8ynNfDNPKzbKLr2BU71QFbgtBHuFxy4eknJ4AGbfoPnv,4909,2490703,1394786,1159064,0,5049462
5DDBQsTxqj7YvvG8LqGpiDNUGqWpb4cXkgiu7D4RdD8Ennhz,332,0,0,0,0,332
5E7uh6Y7ksGsCsXTpv6UuEvY1oFUtRU2iZNzLwLwJdbLjFyz,91447,2271952,1877033,1053739,1420438,6714609
5FkGekbQujT5QxaWWBQ42H9b13QqUr3f3XvJBoQCaQgmJZDE,3470,61288,60386,35519,40528,201191
5CRzjYfKcZUNv3QQasqjYrHUjM7kiubHJWEVS2PAwcubMTLK,2503,44211,43560,24421,27864,142559
5HWH5vZBUPwGSV6h9vRCjvunTUdRxXy6ARk3i8YYvjniW6hV,2253,0,0,0,0,2253
5EcexHkKTSxDefrtMp9wwpa1zzghAQuyTveTCQdjc1AzfJfn,644,0,12678,0,3059,16381
5HGdtG6XBE3UL21o9ddRRK8DgLgUSRuoT7RXL9VopkxZZvaK,966,20315,19017,7333,9884,57515
5FhnQt3LJVtoDXen7ZVZsJWv9xsPUvNYF5XATQthYV5VDdYU,325,0,81269,73045,116234,270873
5G6fA2XPNyc9C9hPXu3zxSWsqz8wuYhsmietCk4YsoViK34e,322,0,5602,0,0,5924
5EZmDJLDKr2VNJGMr2qApsj3f863tMuA1FyscjKdwZX7Eu7Q,5185,134348,106556,49225,59181,354495
5FbxHxwwszTT1poaJVMVfUwCMDAQZP8ojk1F1zFzASFdDhDX,1812,38104,35670,13754,18538,107878
5EebAWtkzxXvhqA1VVptH6CVu9PKcuyQkn7aHBr8JK6neMLN,514,9068,8935,5009,5715,29241
5DqcyLHcNYK5XPubLEY27PJSDyYZFmjAoeccvhkQnDz8na2z,7403,197198,145794,76342,88962,515699
5EnjbZdkFEAMs9tp558wLuCoKzyukhQmUkKhTNVjHN2Uf9xV,644,11162,12678,3890,4592,32966
5D2hBZuy2ZbP32Go7ZcxMdH9uWf4LFKrMSdBZ9dZqHjoNuJP,2866,74785,0,0,0,77651
5CwAWfJ4aACstz3mP59sn9T4JrMnf3vhShQSEnaQrZNS5z9c,767,0,0,0,0,767
5HGx6FNL2VnzfkkPMfdCCS3vJHcDoF2pTAU4U1QYrCzKonuJ,322,0,0,0,0,322
5D5VpbEpRZfCsg1K5n7ZFMBE4DD3R1Cf5k7c27Tz31xEMEeN,322,0,6140,0,0,6462
5GYYUbuqmHL9zUG5HhKbKkbMMwoKhEwjWJdHxnaNqf47uaYG,986,0,0,0,0,986
5EZ3iAHBmPNH8R7EjmPn1R7cVtnkAJp4vkDB7whgPD6x9ezn,335,0,7142,0,0,7477
5FPGtKWCQYXw36WnhWKTcPMNXYsPY33eaBqieNmN4mbhd9Bi,658,7650,12941,4990,6726,32965
5HKiKKyt1LBdftJVik8aqXukWnKXqfP9dHAxRZJeP5J8kzyu,2987,52759,51982,29142,33251,170121
5GHqtGrdhUb5Qb6xNZ2HEHSjCEFBnucUnA4zXuXm1vZd8yz2,753,0,13096,0,0,13849
5H1hExL62xfyaHQgRbsFE5WVFMLcpjavB4jRH4E3kNLZ7cTv,1627,0,0,0,0,1627
5CPwZANiCK5SgrcdvAWtZZuot1nnJ5Ep5FeBxiVhcaZafgio,2483,64774,48891,26890,34546,177584
5E9XhGxvUEamnwZN4ce1N6B4mJaFC9J87FgYFZtLFnwEPxCE,322,0,5602,0,0,5924
5FTshRde6eEfrUfTT8Gj5SfU5m2Gy6ygqW5syPj6Ma8hxU3P,4828,125972,95083,52295,67183,345361
5DyvjrMniWQj561PJL5AZT3nzmZEQ5VnJpuYMWwgVFqTqtor,1134,28189,22327,12348,14348,78346
5Gj3vW4WuY5D1c1cTAx65HQZPamsEHXAyVrZmPbMe6PYBU8p,322,0,5602,0,0,5924
5FqDYPiQwQvZWPpH1tZrUZrd8GzKk9kvdiuAu5N2kDH1jeBu,322,0,0,0,0,322
5Exci47cXTrGbLoXhSJepSttspLbfAs3Nx9X4wHmwX9adEea,1863,48613,35539,20181,25926,132122
5H4E7vBqJTdYQLN7UHSLrq6HbBEFtRoWocVwAJTS4dmRNzgk,327,0,0,0,0,327
5DA1RZnPnAG1Nxow1jsSKp69WtZmxN3YsvsGaw2tvGkoAcKn,673,0,14354,0,0,15027
5DMCGYvgR4p8yd75Xbmyfo1i5X22egHqMfjyEMk7zDQE3QUV,371,0,0,0,0,371
5EPJgJPsy9wbnLrxs8FYNe7Qsd8csisq4ZtJeFgwbcwtytiw,52449,1368570,1032991,568132,729883,3752025
5CFtNaHyzTLJqKaUHcE18dioV3zyaohvGCbf45A2g5TnqbnE,1024,0,21831,0,0,22855
5FKfhXHPAUahP1KJBuQtDhrBbb4y24jkqRpTuD6ZCvhXP2rD,403,0,7002,3926,4479,15810
5DvquQEReoSYVvZheo1zTgboMuhNxvZGQ2ensf2dczfa8Jah,6429,167747,126615,69637,89463,459891
5C8NaTEq1j5fvGzXK13yE8EZU6nfjS5EmAELiqf39pjZFVdT,483,0,9509,0,0,9992
5G23Td8AohP379BUH1M3TfZWK6H2LkgpYsihhZUmXbFPEe1p,322,0,0,0,0,322
5DCTLqs2ZTs1RGQ5ctwCrXmbwMZMNmEviMV612VpvpGkdAiN,3220,684465,726382,0,0,1414067
5EHGUSKgpQ6KB9oqQVoazpQHjijhKyXwkGtFkhkQWXEENv1k,322,0,0,0,0,322
5G6Hi2P7AfvDMhfSwDLxhzZkxXLYG2g7X426nQ2qoFjditsH,322,0,0,0,0,322
5CkSYSdJykZwaAFsdenpUrJRZ6NC3Nh5v8Sg1MAdtoJg87U5,329,0,5720,0,0,6049
5G9J4iCXwF4XMYR8aKbuPwRx1kmqhfEnTSacZLgDCw1ngMfj,1628,21788,28317,15875,18113,85721
5HgZ9Rcumf3JeheQc7LznpebMKHAtZbAwEfMYDfdkfp5kArz,2610,33301,51402,11235,15001,113549
5HB6GvPgSnm6hAvqDFffn3RUWq1S5eEtBytPXaBoxdJqHuzm,2253,28747,44372,9699,12949,98020
5FkNMzrGnxGKwcUKbTXoQTn2Ve3rBoAmjfKdbYt4YDKFRZhm,3219,0,0,0,0,3219
5DhnEdLo7YbfVyrG4wFZir4tPL9vpkVLt8qgSxckYhr8hvoL,537,0,10565,0,0,11102
5DfU7NL9Hs5TCEv7zvrBDsueyxDnu3PU2Km2XHWDjpmuYq9b,5436,96016,94603,53036,60514,309605
5DSCrah5kcAjU9PoTUd2Xgeei2P5V8UUVo887PbknvrbJaKT,322,0,6339,0,0,6661
5EjgpGT8SbTb3iDqiL6UmtYbntK746aptEUhTeTmE4sMHikM,371,0,7290,0,0,7661
5EoL32UDZGCxCQTSvhNDRwvykfRR8aGrdqmHKkcNHRGykBYc,6693,162829,131809,61835,78019,441185
5C7eay59YXqBvgyXwQaeV76Zmb9kpEvHSJM9n3itj8NSLZht,326,0,6410,0,0,6736
5Fs6Xs8sJkpm2iWxmocjCfasSnSG1WSjHJnuwWdzp9UiVCij,2293,0,0,0,0,2293
5FdtYepJ5mLc2JnS7MEUeUUdHKVgfKVw8n218jY9PVf7nUvz,835,0,0,0,0,835
5ExYEjJrH4J3DeJyGACDzg52WKCHXjh6ucEZ727ZKWpx9Nir,1106,19523,19235,10784,12304,62952
5DXF59JTLYxUzwcBui8b2KNAJfs1NW2eWuNvKjUbNcRn1my8,2253,28747,44372,9699,12949,98020
5FEfGsVhyUy6FUeGuN1nJAFdWh1jWovv85JT8H6tK3PhoowQ,486,0,0,0,0,486
5FR2CBnbGzPytXXp5Pjzc6bPU7651hvGSh6z3KCVcbetNZuU,1801,22973,35460,7751,0,67985
5CuD3ZTNZQJCP97TxwC9YRuXTxtkrDK515y7jUmgLREC6tMi,539,9519,9379,5258,5999,30694
5C4qDghsTLnioD8khiN6sJQf4JcfCtX8wAQPqf83c36XJGMu,11004,280268,216714,119190,153124,780300
5HbRj5R73eZ7YGSHgE8QAftfpyNQyH8RfddDh44UfRpG2SDW,2670,69668,52585,28921,37155,190999
5GxsmJxBrM4oHFQyk8CRyCBed4J7fDUGMTqfXXyV8g1T9P38,32185,974459,633885,363776,430223,2434528
5FucDsTdGvJPvPyn2iC8rtfFUst12HAJx4aEroFKa9zvXrdD,1004,9431,19767,0,3338,33540
5Ew7cjJhkdbyCAvm7XuNYYhGzDhXPt2UWn1DL26Ha9v32Mvy,3180,40572,62624,21839,27417,155632
5EhNtPRQFES2RTRUETVCBMDjhwFXHAJzXwrw4fr1wNWYsbJg,10271,0,0,0,0,10271
5DtMSLyquBuwLNfeT4yzmr8M5SpXrEtPu4di8588u4krCbL7,322,0,6339,0,0,6661
5CBCq8uS94BpFkvyPu6okhJ8rha37GgUqwRS1i298znmizz9,4007,59396,988908,840015,881374,2773700
5ChoXsb3ad1XFVCQqW1dx3c3KFQETLLP7pGwWABVNeR6K5Gr,3219,0,0,0,0,3219
5EJDA9LLj2gzrvaEFmU67fATx4sepraMzctKxYqxcJxADQEQ,620,10941,10780,6043,6896,35280
5EPixJ7k8ZHVuftS6zVucZaGs8eYYfyYXhKZ9oKJuDUZkHfC,644,0,12678,0,0,13322
5G8tGNtCjmyfBpEzBnQPDmFPuuqwwDFnT12oMwFJ6nWPXfcH,1355,12733,26687,5833,7788,54396
5GBxBFE4yG5mYkafeTAot64o1RQRBbjcdt5nZg2yxnFaWDrQ,330,0,6490,0,0,6820
5EeogRaWxZ9ip9YhiARS1Gqn5L7mdas4pD3QMLhuEaz9XbpW,5358,139790,105513,58031,74553,383245
5EUqLx1avr3fVudZhhA1mryU69i72sNgpSyjqamrGnBqKMMM,1465,106108,42733,42738,54395,247439
5DbuZHprgoxs5DWjtFpc3KbB899rzJkjEKCUg7pGscmr9wmn,483,0,0,132291,141956,274730
5ENr97uhvBm8pi4ySnPEyjwC1EZ4MUgcSVUYfy9Nf9qYNph6,998,15977,13932,6439,7183,44529
5CVVnQtFQ9scsoY9q1oXqYkaDUiLBJjBiNend4F2Gxn1Yfxk,322,0,6339,0,0,6661
5DXSZUamEFuwzVeN89vYCsworJccMXjF3ugrLDLH6xbdSUCK,994,30025,19571,0,0,50590
5CPtHyGaQGNcXhAKjmZFheDaPhwJEPn6LYYv4VCtT1jwT68P,608,10731,10573,5928,6763,34603
5DDU4c4Qi5oMbBYykqu8H7ieSvhF4i834LcBwM7oa4gzhCNj,1610,15122,34339,6928,9250,67249
5HYWin4b886Kg3QUav5zEdYAFsy335p7hgBfveH5FNwQ8B4S,837,0,14564,0,0,15401
5D2ve8Ww4DtTb9irCRA4HZcxVQzwkfdoKbL8CucXZ28S5pFm,5479,96765,95341,0,0,197585
5CCgeo1f1VENoXmwm6L6zaomzV7UWZUuRBWrDZzDxYx8JXvM,743,0,0,0,0,743
5FZffwnejPGumQRc82Mh9LFhfGc5j5qrJo4AtNrwK83pxXfB,322,0,0,0,0,322
5DfT5iPvhbTtkiB71xgqJgUjJMNkXHhcgKEpXRAY5dCnKXSr,2018,35634,35110,19683,22459,114904
5Han1FUoZRN3bZMv6ptKqq8MraUgPQfiSTNnA1o9XedJo3Tz,322,9725,6339,3868,4557,24811
5HDvDn3zuS4FSoBWyxCEpPW9KzDi5jVgGLSEgKZsxEkmDwga,966,19714,18419,0,0,39099
5CouA8pyo3d5g3rxCL3GxM3tbtMnoUkatxCDFtqmC9u8odgf,257924,0,0,0,0,257924
5HHY7EFqZS8JhUcGV5UnJzFx1FbdkjE88dPUJ36qnBHarDsP,1518,50012,54421,32271,40531,178753
5E7j7SiQ1pEPBMqp354erj7ubap9tMDCPojBWYLDrf7UQm92,262,15817,9392,7243,9246,41960
5DAUc6Y1cbhCQMVzdMdrNkJSo7bpP7qvvrnVnzKhKTY5PNHy,4041,272225,144888,118608,149497,689259
5DZkPX5w8kotQw2aGFKNx5hszeGUFa2LTbGUvvK3HoPcRv6B,1741,117288,62425,51103,64411,296968
5Hgpd65KwocDcCQzcnQctq66S5s21tfQyNuZm9wyRWxGAfR8,183715,29745796,20604906,0,0,50534417
5GgaJowipuKrDpTvgEbYX3VNeRwrPnerV8C9ZqgbdVXnLkSD,2907,209606,104250,86746,114758,518267
5Gb7grGPH7R8pwuErrxmgvtpryH62HrE1moNurGR1yNYVCkd,1205,86877,43209,35954,45775,213020
5D2gfb2LiGL5Hieov3FdTgXkb6QwU1B9XDxSKfSGF4hXBL5j,304,215540,100505,0,0,316349
5DfYCfMFcAgarJNnK3UPBHPo44hmk444JqjaAvzQjhH9MGth,517,45965,18512,0,0,64994
5D4xg1cEszh6jgD9drcKajV6sy5AG4nDjMee8JJURkD9n7dR,1874,93284,67173,39832,50028,252191
5CPMEVobUEzdbg56tgzaiXBmuaa3wh5Mpca7VQAceoSMhEuX,828,49948,29659,21576,27542,129553
5DCjfTYMozM3989WPCHxYMYR1c4SNMAJRvSvCiGbsTuY9JC2,547,0,19608,0,0,20155
5CZscV2SvHgL1h6rkpEPDWJoDEd93h3kuEQCoJQpcgUuiY6L,281,0,0,0,0,281
5GBsSuJsp9iaHbJSgzqMWFHQf1Aq6rJ96S92E6aQ4yvP5c98,310,27518,85779,95207,147692,356506
5F6cDvjmZv4fcLRJ8qpVrW6YNYoXXzBpjcKp8ctU86ie3x7L,10024,534178,359477,223831,277320,1404830
5HKaHjiFFmR4j7EVoTeEwZFnEGt75EbwGiQktHEabFbVVMtX,1733,154292,62139,62146,79096,359406
5HdwBqF3HW7xQLqxY6c8usYTKXYdiWFNkeuH4TpWZSMNMUad,380,22947,13626,9912,12653,59518
5GBV7kqxQgp4ArZqhTPKPXoJKdQaGFJe44SkUDGhTGgxxoUG,1260,84887,45180,36985,46617,214929
5CJfxfJyjRhP9GJ7cMqgiTPedt4W9UPeeAX6t9LR97wM3kzo,350,21105,12532,9117,11638,54742
5Cm8z4ZYWHo77T7T8NNSFw15hz3spLE3EyRLB27LEB5stVHh,2230,134630,79942,58155,74237,349194
5D2ENjFf64a7vKEjiRafNsoEHWhU3aLeu3kXFoSJjxmEzhab,4540,305852,162785,133259,167964,774400
5HgE77xZ711mmtmKSyM7KPvjxQAGyTLjjiiRzdQaMbtxGA8m,1204,26261,43178,0,0,70643
5FvpYmm2oHnbYmhjyvnzyi6xGTJgjDHQb1yV2D2AeX5mz5ka,629,55990,22549,22552,28703,130423
5CPyDoSq7JpcqzAGbLq9MhFdUVUwdoLL5vJ7ce4PEwcFaqSK,1179,84976,42264,35168,0,163587
5GRFLze9XKesGVNn26a6xKWC7i2rR5dujFp2MtvDKHm5C38b,1169,104044,41902,41907,0,189022
5C7szSp9SSGsdrm8hGLy7wa1MmzPP571j9VrKUwhbnd1bXb7,12897,868976,462500,378611,477213,2200197
5GnJToGTWQzFmS628HcwrDGvWsxdUaEgYSLQXc8Q99oEXPAG,295,17787,10562,7684,9808,46136
5HNpSS68g5vkgVroSJhd39DZ6uAr9vgktCHdtzi3cVyeFVfK,280,24860,10012,10013,12744,57909
5GKaDhSh6YMnb1tdQKdNqETvv4fXdmeCcY2227bTSzhPkme4,2439,138957,87438,57755,72231,358820
5Gsu5kV8qLyyuH6HAzsEBmjWH43jsaZyce58jkp8f9xpd3Yo,599,43190,21481,17875,22757,105902
5FGvAkJKEFwXdjiFtL8uatVKP4Lvzfn68BvZp4HHgT8KKpXc,1837847,77448109,53661563,34065953,40775460,207788932
5Gy3UZNmZZHFmSjF42EEPUMvoF38yF3TQsavyzvDjRywzknr,68227,3828908,2201893,1316798,1627350,9043176
5FjXHB6mmjVjhKnkDQCnCT6EMYpgYT1sR1kjzAqNSRQ5RZJP,69884,2963917,1663301,1795191,2480016,8972309
5CUrsedJbBs63ZLMCgcTitns3h6DpVWU65YT4pdQG9j1f2Kr,16468,897596,446266,416972,580974,2358276
5D9qx8KPfU1Vw9cUcivPmUdDkypuMm6u2B4VN45JHsS3o5mZ,120312,5658994,3024338,2509145,3547940,14860729
5D7odCxAVGK8VN33A5r57pMSfrbX7woCFjW6Xr8cef4A9ebo,9860,0,0,0,0,9860
5DjrddYDAZuPQmDM82TWtRytnaSqfAZ5PACsvLXJtHM4ddgk,88535,4323348,2430836,0,0,6842719
5HBxDEZ3miyizXM2ypQQjP5DEuXZktbsAEvJ7ruD6pNXP1Ce,7625,322008,181464,224406,291860,1027363
5DCXBC68jGRnJNu8XXwW1PZmZT4GozWDMcHkaFUBzXkEBCFN,12912,457292,324575,213139,298344,1306262
5D2ExHtzXDmNTRFFVNs5tGAJzWArECwAonYeEfntcdemogdg,198301,9153964,5473433,4167098,5849022,24841818
5DHcZh5SGH98A56ei8tUaFmmJUf98p38UXkvfS9L9LnmM9NP,3963,213453,0,0,0,217416
5CmCSz1o5Wc7NeQApryNwjjFQeLc7u2aNJ1d3hdbcTgwC7bd,20595,599662,517703,361422,545100,2044482
5F7ejwiBuZHW762gQDNZSwqEkgbWGYpt8or98FaJdZb9FFVJ,5027,0,0,0,0,5027
5FjrUVs3jjyRMGwpy7bCnnhLJeo996C3P89vzzqS7gtaGE8g,13369,430377,336043,198556,61561,1039906
5GNdtfTm5spCRP8KjH7ruBY9mCd3FL7rJHkzKpbediKWji4S,10564,0,0,0,0,10564
5G4mJVQwwouTVXw5hReHk2Z6gx6VvKXK5kkrbd8U1yr9FgFn,29862,1673923,919217,0,0,2623002
5Dy7M13576B8fyeLCuzcUajM13U2TXYRvJ6GyohXCED68y6o,3565,123494,89612,0,0,216671
5D4iUQ17ztuaEgkJBWFKy5q6hUyT491jWQrUisTc8UrmbNk3,100972,3909967,2610039,2043909,2618284,11283171
5D7XStUggF1wtryY7sgAwXzmterXd5NcLwDmGs1GS8uFT9mu,118956,4558564,3251658,2079888,2710743,12719809
5Ea1NFBnKBBH4mJUXUqJihGGoGvnRgK76tC2g89j7wTx3fEW,2950,0,0,0,0,2950
5CSHhJAVEQiaHBBBLLvdAbcr7BsQUbJEti5uvfF9LoG16SAX,29080,0,0,0,0,29080
5H9eYsqjPrm3FPEX3fYx2txa341UGHaJawpaBo7zQHHpPBZz,14927,499970,465822,300149,426342,1707210
5GxPq2QvrSXZFsbiNxwxomjiUWizNtdXJSnzDkVMk3zmKngf,2826,96833,88162,54829,0,242650
5F1bEM36qZndWWWMJCRrHGrwNxVZ2WVevwarRehwyM9HGnzN,157345,4915639,4910317,2393952,2810701,15187954
5F2KC6zs9DRwAhSENZdecXKEDbzdMntx2EEHdEktaBRv2ZcG,29645,832517,1073888,1026557,1106401,4069008
5EJRzJQBX5LaHu59yJsi1yifD3Tj5dPCAQw6q2mRJfNnSGFD,2292,78530,71498,44465,0,196785
5HExCBCo4yZL4xs7rw4T9uf9GU2yQwRxFKcNmxcg3CWmMhaE,4441,0,0,0,0,4441
5ECqqtLQwL2wd7eUQKbvUmbxj7Ax6Jt8FGss9ou7NYZjwvFs,8639,447232,269587,105921,0,831379
5FbG4SAyuHEtyqnqFXLxnaauSHvYBDg1CoWh66ExPtkHRADd,4389,171674,136963,86499,112466,511991
5DkgWFbuwAqJ81HWCsGHrjBU5yR2ksDmqRCyL4ufKeDCcGYK,117416,4707879,679493,337743,429223,6271754
5HfuRgzrtuWtDqE4Pt2AYktoGo8qYRRBPDZg15DJXu6nWg4N,3178,93787,119473,122523,149118,488079
5GWgs5PRWmLAnicmRQTczV8sWYJLjAv67xxnExfqLyKiaxhU,11454,364159,357430,187594,243918,1164555
5Exg2qFcBBWxL8Xef6Ft3oc5GQXFZnq4jec97767XjynFjbU,6629,0,0,0,0,6629
5Cm1ja9NPYR1AyEmBjs2SbjgppFrzXvFaquxLUW7iADWskCa,2920,93458,91119,47607,62137,297241
5EhZANTnjNeaqZvDawmwiGr4atzV1zdtwhPZadVMttHDe73D,25940,869600,809502,521473,797020,3023535
5DyaoK19UayALJcYbB7hxmGGpHVYPZLca8mNxzvPJFg3RWZz,3156,163380,98484,72991,89999,428010
5GKu8BT8Q2WUVtiJ3com9hzgiLLzMrjpPkW1dYdnHaU5FARa,5908,158508,184363,83659,100011,532449
5DyFHYoQ66sQiKVDxZeyGcmMuG25q2DRR96U9p4kPQFQpa79,4561,136136,142329,72437,94310,449773
5FNDEPEamhSffZJHz4UsHAZnLkmK9U3idWDgbFWm6Dmh8ii5,8008,305255,249882,155404,0,718549
5C7a7x2QCKoynMf96xiXSA6tr2NdRAe2P7QcmRpPyLGzTP6c,11402,299909,355821,197794,263109,1128035
5HYuJURnK4MVpLbyfLZjhAV8c3BSE6QSFV6anafJeWpoNT3m,11699,605648,363545,269440,332223,1582555
5EZfzSvfe4JeVFNKm7bAuusu4BBTQAZ1nDkgknw5pR1EXr8W,8732,0,0,0,0,8732
5HNE66z29TYnnR8LzJ89MQd7dEfmHVkw2HLJtRX4vBRdUeKx,2281,102824,71165,47010,57272,280552
5FjyV1ekrZYby2yfVKtp1cVMtdxch4q6oSGhmkVqi7qDreCB,5651,0,0,0,0,5651
5FEmVUgdT7kfZSi1coyPAnWA3h2an4LQXvLD4ZWPUMDpziDL,13320,0,0,0,0,13320
5FEkNaLgoKgqdEKKZFcMrQXkyb3HhjVB7jou1uvv977mDoUr,9450,360228,0,0,0,369678
5FjHgQMneg2LFAp9eaEACsSGJTL8EzJb2WPjYrVPsBHh9VDM,18243,944465,569313,421944,520263,2474228
5E9bzq27AbbS2LXFVCfxGkrpGFSa5cvg8KBorHABnbbyZzcX,2296,118850,71641,53097,65469,311353
5EskxZed1Z4JqRHV566JdJ9VXeBsXS2QJ5Js8CaNh8ewBRyb,5396,201313,0,0,0,206709
5CSrTXhRN3hLWH2WJ3FAkoYTtVYzca7UTQiJJ1RCHy7PszRg,21751,0,0,0,0,21751
5FWNrFkqL2bpzcSHJaFePthjgY1KXBJ3EeDVG2UdzRAMwxGu,19512,640298,0,0,0,659810
5CkTsRHXpCLC5ERZQqKvhHdZGc4zkFym9ZseS1Udd5QHbaQ8,104229,5730200,3100884,2137839,2521949,13595101
5GNr25Lk5Q8mTAJsASdhgFzJU8diBD6KJKaqBcNFe2NwqQKV,3043,156452,79443,66341,79024,384303
5ELAnXWvM7wSwEmApBEwCY8u8Rwj4VQaaHiJnE1VhHnAUvaX,17509,828042,457112,324646,441727,2069036
5CQMZjySqTaqumzLNNZd62uEms578qUajD6awoYJBn1asGm1,5119,224724,133082,135825,187162,685912
5CFxYyXYUCshnDm667kSmBm4eNyrQoFGePwn2rSbhtm1PWUy,15215,834898,2230876,2339510,2988952,8409451
5F1u5D3NwWTs75RukN4X3Z3zrUrV1bNGdPZL8k4cMEqP2tR3,4991,263853,130286,128380,158582,686092
5Co8PrQSboadypUcwkvYHg6wgDnjUNG7KbQhmSCoThsqT87o,24556,1239936,604804,509639,721725,3100660
5DCLEvMJZeWHsHUL6eHNBVRkRRUADNvpVhrPnd2CwWeDX1fs,143040,0,0,0,0,143040
5Ci4oXJdGRNC9dYN54Lf3QeCo9Kvw9N28AQeWCE6xtyN74cW,49523,2271782,1374774,0,0,3696079
5EbsZ29narWsDeE4QqHuSVHkJEL1QazFCGiCrbB9jHRqUbF5,8848,434337,230986,185006,250534,1109711
5ENgmM22rms1ADdzmC5Sx1rNANuLjoMWhUgSZZhNVBWk7wFv,30429,1531188,914457,0,0,2476074
5HVt5oAf1F6ZJemMJPRU9KtDB6BXdyu4LEefwiChjdN6Kdmo,16270,747198,424767,305819,0,1494054
5FxQbC64mUDnPH6oDnk9gFNynRFDatty2HKPwKqmwmsWLqHv,15215,834898,397213,391563,502347,2141236
5ENmw7BQrEi8K3UpshsULFgKH4Yu4V4NYDZ1A3TNBE56zDL8,152246,9548227,3974847,0,0,13675320
5G9TSxQmts4caFFztNACoyzb4LbQjLJPyb5MbX3RaqLSqjXD,229861,10097663,5480643,5774572,6616579,28199318
5C5uFRjpZvTm3VkwGFUCwdNiRGFoWwYJqESA1QXMA5ejDZ5f,651589,30740087,15555514,16157392,18736251,81840833
5HY9x3QJiT97DDz9ZUwA8K9C3QRp822wxLYGmHJj1HqFLpmE,121830,5411167,3459210,2189877,2405224,13587308
5CHt1rKAP6VAafN1pahQffmYdMWYYegqCtzmR55f3K5U351N,36901,0,0,0,0,36901
5DFguBrzZywS51757tMLcj1NvZeXd2tiaCkqGa6XQWcDCvfs,11673,482725,295113,247312,278150,1314973
5FW2zDuspP2ZVvuTFNxirSH3QfFAfuaQ93mGzuTwE6xoHuLT,27155,1271441,562668,528533,752006,3141803
5HTtBgs2BZbacgNR1GrgiXDLnUV53G2N7XwNVNgSWgZFdesj,22221,943956,460434,387985,549446,2364042
5FxWgDZXfUfXS6DtUNC5LxLmVHR6ZvortGQVcA1irVQb8EYq,154697,7884932,3613268,0,0,11652897
5EkFrwsQmw33AhN8ZTDrLYuZYjS1x1xB24z8uNVEiWiap5zz,31398,1276696,708057,592856,692795,3301802
5DtHbrZZDDL9MQ3y1vrhx9VPhehrExcP8pgyijpzDPLPHRUZ,75705,3811685,1768248,0,0,5655638
5FqcS59S8HdHeF6NpyQdXfRpuRmDeH2Wut1WbouQS9n38eeN,12521,311841,217961,173273,233740,949336
5Co7rbEWiovSKWEfoGJ58TSAaRAT5xe9FshGgBNc3ujJBzmm,10270,255769,178770,142117,191712,778638
5CAtWci8f1x5eWctVqyeNLxc4oXQ37b1W7fk68hfuLiJkpgx,27850,1266721,560636,666471,0,2521678
5Hmg13rpsWyVyGjU1PNzniNnqKp1Wwg8QhVU4yqEiB4jUA4j,16792,688281,383510,0,0,1088583
5CAAJKduFykVGPQb2Vjmvji2Tsv5RR2Pxkumg39fui6YHvEe,23976,584377,419114,323913,432693,1784073
5EUqdDqkRrbCnvufaaYbVG1uh7YDHsuxtkp4eggDiQtHVmHx,7234,396272,163130,0,0,566636
5D4cQGQ3TDgbJYj7oH9eHZpRft5kTpA4cTHPvLSo1QNvF31F,8070,338151,167217,141038,228699,883175
5EpxxsBBeSaECLkT6B7e5qRZKHQ8JZfuphYRYCLrzsT5Kzbu,46563,1978043,1022734,836123,1184077,5067540
5CqTD8m9rnzCYGaq3nKz26Xu1XaaMWS5zfZSEZ6gZAxfsCLQ,9404,0,0,0,0,9404
5DUQYMerBoeELFzuVHhwEvzZ1kL8q2UUZJ6ndWK3i78oajf7,16168,0,408773,408025,430788,1263754
5H3kCQMqCDmpfs7NXgUYgY9r8qC7p2g63qozrLsShTv7mGqd,18085,938419,422392,405179,556414,2340489
5FbXrUq8mqPDc2oq96WiVQwZXPmNqXzyi8vG32S8rZBMZAeF,36169,1315741,717636,741771,1047688,3859005
5GsaVsCkqqUgoTdjA8cWEAxA683n58CiG9w48VYmf9wqvxb7,38639,1676631,871364,679395,960721,4226750
5GFETWYj1gpdrbLLRZqXUqRor4THLJWNW5c62t2e2buniDNm,26548,1052424,544216,523584,682443,2829215
5HBBBWVPWd7PGYdYW7Nrq4y7HEcpAAVpyZ7jeX5VQ7phxvNz,5332,240334,113193,125704,151204,635767
5Ge2Jr3a1W3jyT8A6YM7cCtTpWzcGXp6SPNNDmbWwERQN5WR,144817,0,0,0,0,144817
5CFKnnEnGPKV8Leu5zgPmrF6gEPwtViqw4uBTTtxEnqLH4dD,82460,3037131,2019887,1317367,1734216,8191061
5DL9A7oxniVjjaKDMdgQZoi3g1TyHNoJvS4ochNeNyAqNU97,119427,0,0,0,0,119427
5FgfC96xh1mJPqEEcJiSRgL8AH7Tzk5egrncy46yA5M5L9PT,33465,1337355,819724,0,0,2190544
5GWNqGzPxTEWFj8LsutRoXCDQeTLQLiDpiTv8hih7S2fRnfy,3331,126194,81573,64330,80009,355437
5F6UqZmqDaKnGFCqk8kD3fuRnqM4kzQ6Su8V3adrC4Y9hEBM,34013,1241675,833159,592097,772591,3473535
5Fq2JYBQ6tXUk94RPXFo8cuJ1uAyuR6CqmuoJUdMLgAqnhtv,178717,7180795,4078228,3062073,3821098,18320911
5DHwuZmR8SbwRYRUamj9dpjPCDggEWEm7xHYnmp1ua4weB8t,683992,37871815,15974088,17476148,21103521,93109564
5HMbcoGqT1SXvSkauyp2ethT7uewxyBBwoRjqb36RLdnqDQJ,133323,6345518,3551459,2470452,2407869,14908621
5D4nBRL6kfs3iVYC48pgp65g6EUwXSmSiSZe9drxFFEuVLkY,3657,88916,84144,91948,123918,392583
5FpNNB4qxtoxyUmT8oTyRZGvU4HzvDBKdKoUvPNMLRgLCioa,3226,81711,190415,138163,154143,567658
5H3QVNgYX3E3LVoufJoKcCAhiyrzuaTbGvQfnqZaYkmbPBT5,9060,273986,426510,225367,302115,1237038
5DSXtp5dtMPsxRtkAgen4qzhoSzNQ7GuMnAkPjL75wKZ4MxK,2276,95566,52583,62459,85822,298706
5H61auZgQvXXATECapVyfvnRC569iPS2FL8JjGLJeLbhYhK4,97762,3125357,2259105,2009784,2702791,10194799
5EhtGaEE4hcHggj4kNCXgdbdr3gYqQETMGTYz4HoWmvysC4W,1947,46880,44801,57845,76370,227843
5Gmh1VpGYwypUkeUTRZZ5ekpqGFKGakK1kCcNMMpFx1bo4cd,2201,69563,50846,52461,72879,247950
5GWgN7gbSmzg52SLLiuKDTkvsLbHwpQLfw9D3aAd9i1R9sc9,5516,142670,126913,140445,189499,605043
5F45Gw9C9GvEro1syRhFH7443sssfbhMhQ37X5gWp3ULi3xy,4094,92189,94191,104598,140691,435763
5DHXFasxLtvLZBh7eJQKNdkyKWeF7triWKH9E7oxePRvmnfB,4158,106127,95660,124577,152961,483483
5Fk2HArUSy276FvNAY7cNb2RHATpVaybVh56Ez337Ro8GDja,1783,46727,41188,50035,66432,206165
5HYdnJrnAHJ8cr2sAk55EiPE8wD8UAuANCqz7a1gah7JtAFg,11181,429675,258373,291774,317591,1308594
5C7L7Rz8xXnGXSM9Q5V7gwUTuxu4tadvVtprq5Qfc6jf7Vte,8079,0,0,0,0,8079
5FZHRsYCjuEJMF89VDC3mFNgabFW1Ya2gfTNAToRb18Y1sUb,1856,77917,42872,50925,69973,243543
5DCxePJgRrwZWmskirvV8be4QpWRU1FkugCdULdoEPrp3bKr,4275,99647,98787,91408,131681,425798
5DNwHanSFEb3JxWrzUrfkhStjaDsT6dAUorPwVnUVNEqePZa,56421,1103305,1303780,974052,1510706,4948264
5CPzTxcBeZvuvqjxNpumpAbJRBHGtMCowNVhxuYyZxP6Dj8U,1871,25298,43224,37539,55308,163240
5CAWCV7h96o4WwwGqd682ZrjxqXoozqnPfrySeT1VqWC8oaW,9294,776837,390686,428456,580018,2185291
5F4DRaCybwT9akf38XngQqMk67kuxe3857gsZSKG5wABndPq,53479,2245985,1235793,1467905,2016980,7020142
5CXWavKLkHg4hSK9168udmVYuvqX591TVWUQm1qxy6SxoMqd,3359,141042,77605,92181,126661,440848
5CoQbre9E6oaSq9RzcqQJCd6qcNEy5d1YyBnpLC2mqoubWQV,1441425,36650583,31212889,0,0,69304897
5HZ37cng5Y5DtiV9Yrne46n9GwBAUKQYiAr9vLujjWddbGj3,148340,4330791,3021162,2038284,2584110,12122687
5H8ajpMSJKZ99PvHbQADi9amXb81amaedT7u64V9HDouQxZ5,30141,1275385,624537,0,0,1930063
5F7GbspeEd4b6uo5T53Ewnr4NXTwPHUoDhh6krMWxkXHrXmm,18132,931425,375706,380184,595580,2301027
5Ey43GWz41qDc3YFpwQ8fo3JH3ybVyzV3jg8UBUsXwY5Z8nt,100837,3687711,2244479,0,0,6033027
5Eqy2JW7rkySgf2PJcV25MkRSSrQPXn2xfEfN8TuHvyJ32JC,145399,5952212,3491772,3063454,3581905,16234742
5CXGjAJW9hbRVkUT3xk8AH8BBv9djDgyzoypxZ3hB9XKSsx6,93913,3695777,2062731,0,0,5852421
5ERxHcrQDcjbfzdnsEStPoiZpPaqUBha2SgfiPXy1owEbTue,53691,2547719,1065295,1143707,1360975,6171387
5HY4JNJNXoQszmRUL1QCKQ38NFBHqhQS4peZny7K4A9QVcWv,72807,2949955,1748457,0,0,4771219
5FsTcF43rSS44tRaBpur5Tr9Fx8FceDjNReYAe13FHo3EMeE,3662,212852,92562,0,0,309076
5EFCiGb5DyxrFwqNz3rKAdyKuJe12JmzCxPYeHZU7h248Gyd,34390,1649762,803221,841296,1057504,4386173
5EpoFABFEbubH2in1cbwo2TG3UQiHsHzcYiRwhQrf2mx9Yn9,144775,0,0,2443147,2507541,5095463
5C8S3hHnWGPJSxkkTQbAmUqEJatvVRtv28EXTLY4fFEnXuhr,7655,382655,0,0,0,390310
5GeWFkaJYrUjJJo86KKryzU6hKXX5DQLe5yuoHS1ATVBmj1u,3685,0,108186,115956,121115,348942
5D5am22WFSuHnkddcAvk6de9L7YgDyjpugZokasS3ZSEnyag,21179,1213853,487993,556135,699605,2978765
5Fnzbc9Jq6fLftxDrb2wgzF2DZB8HS6dNNNn2SmV9XKAQsw3,24947,1141410,574827,0,0,1741184
5ES3oYmq7jjRE5K4h1LQZHcmNtdfXBKNbRiRPsV9biW2PRpi,3355,146388,77818,77476,101788,406825
5GZME4sKbKuUeUCAfrysggk18PjryFHRTWK1b1vs1m8xTM9d,11019,693723,284828,289396,377616,1656582
5FhoGqDx1gjDYwS6KcbojeWE5crbscTF5siaM3EtWLL4ji7e,245685,11936928,5838839,7107998,9463855,34593305
5HQnNUDQGLj8xu2b47AxCSpPxWWRZAeu7Y38BaJuffr3vTHD,12489,531332,299452,257155,377236,1477664
5FZpStby1tcA8Tj7hhHLPH1sdovvon5hheivuXxSPJYy5ww9,68549,2986629,0,0,0,3055178
5EqYuu5pLoWi1WSc2HiLw3aAfDtKNF5196sifDyudJVq21RW,569086,20997421,12707730,9814798,14379269,58468304
5Gx5tvPdN2YJd6q7bzAMosczeab6CDrsJCXGhcYgmY2qBpPW,124703,6120197,3124820,2007861,2728397,14105978
5HafMg4ZNNYpJ1rMqkj3kzPhD7ZgZwatu24anXQfyKkZUpWL,2677,0,0,64348,0,67025
5DcYAtJk9Q7Gkoq6dAJYgEydu4fpuPimFfvyN9tCxupZ1GFY,26542,714154,1550062,1469703,1793324,5553785
5GRT2VdxXYLiZz4jCRKnHmf4Hf5UUXAd4Ld3hDvWbua5Kh65,28170,0,0,0,0,28170
5FThLZj3HDEaZvuwFMBG3e2f1BsPYnpTMr6PbXZy9eAieAy7,71850,1900213,1539072,938673,1202386,5652194
5FWk6DUspnBXiqAfJCZrndRFqyNN1pSayTn4iHMpzxVpSoxM,2106,88763,45106,41211,54957,232143
5Ci6fzQfkgAK13Uqg4n8AH9Q5Py4N7CzqB5pG7ptLW75pHJy,132485,3736870,2826007,1705630,2288504,10689496
5GQoTUFGP4CJvTZBAoXjdYwzzTVaeMTyC2zbTDzngTG9vCgk,2323,55368,49925,27420,35804,170840
5HWF8F5eVmnuQhYWTLmeuCBDhmyEEYev8pWXq9QHmYm78imt,28871,908748,618429,404888,535642,2496578
5EyZPpYehkq1ffawdKhcp8S3imKySyegLv5xzVzattRVnmXF,25614,689183,1655919,1302555,1627066,5300337
5EYz9vnqrgnVUVzVkEDiHcCzhkT7TyjquWhRR1r6LqbZe8ME,4399,0,0,0,0,4399
5CSfiS4ChuT1pJ2EVA3x7LXZne2XfC9rmqZwnEMmmvwGa8Fy,2834,95249,60698,46415,61991,267187
5F1j3dfetsbDFcFT4BhwbTSCgy7CzCrb1V54hLcNXPave4MV,1181981,35022449,24656924,16940870,21734334,99536558
5DNnZbexcB5GGws6pkZyMosjcYYGvxDs2FwBTkNieHb4eaD2,136965,5339392,3240083,2159966,2789624,13666030
5HdZA5FE1Jbjc6Vft2mwtWnA5uDymnkWi5u6Suc77gwP3bpB,4120,185501,86871,85997,114789,477278
5HH3myz5J4z3ii78mtAoswx6B8JWcnS4ZEdr8mmZNk1H4c3Z,165018,5040497,2538255,0,0,7743770
5Gb2qzxWDrcfm4go16FJecMCekotznYwj61wvSvbyDyoCoCb,41193,0,0,0,0,41193
5DNpPFFgmpL3BaMbXjsGksWqbjdEQwARdTSmCtUYQBpGgfdw,11946,438490,0,0,0,450436
5GmsdXAGNQDmzYLp38vNLStZnj2Pp8QX4C1Zz9Dbn3ESrZyS,102981,4797561,1873619,0,0,6774161
5EhK91vhUDK1c2gwp5TQ3zqMK6rX5YUzzpXcUkmEykRim9yg,42784,1711553,778391,0,0,2532728
5HVW9t9XxtAbPANMKQqUpNvCSbS2XkVHmbt5tBn8X9Gv9UYx,82385,2955549,1498895,1174919,1831268,7543016
5DFdtMzkhh8XPwEu3JvgTjedS2WnP6fn9VR7BudGE92GwwBa,8239,0,19621,154237,214241,396338
5DSKBUuXA92fqGFrDvReStc15QkTrNpeMWztDMLo8KKzjy7F,6906,241272,125638,99770,150016,623602
5DU3upNDqHgr2sXSxsBP1FmPWMf9NWmNGMCr2K8erUjH9EiQ,74147,3416773,1349012,1503985,1898447,8242364
5CaqRnPZuir15H8fR2Wk8WS6nmcxWgfPqAw4pEUQrZPCDhjH,96224,3659752,2012188,0,0,5768164
5HjJybnPSRzosxEneRSehA7iNpe2W6w7Vy9p4g2iMwa7TgWu,12975,583015,236054,289916,389094,1511054
5DtCgyD4CKNCBxVn33S52ZWbp33VqxDzeyyQDahTPrcJWmsr,365541,18079217,7307700,0,0,25752458
5ELwsy5vdAYLn6ANiEBmmdD25J6bPLY2XDmHkZKFM6tnSWoN,164930,4981116,3263192,0,0,8409238
5CFoPKdfQpSBtefLWf7gPNSc5Z75jKCW3pihDW5jqkzGPsV2,3273,91304,83137,68373,92294,338381
5EtMGofuzZsY3HFxjzAVYzS5JGZ7couz3Vm7FSdNWmiTeVFb,11760,346410,298756,185213,250917,1093056
5GgiaVvb75sMYBAYUb8JfhvMi2RdiJqLGNHX1ct9BRTpb5H2,13458,0,0,0,0,13458
5GC1bEhaKnMhsKLtJY5bQKFVkwYPPq7VG5zNjL6rH5h8Y5Xe,363610,10750245,9086788,6232816,8383891,34817350
5H6XkNtMb46y3ePz18LZgkFAtqHtjedHD4opRRVLEXmsavLo,35921,1230244,814714,709215,956877,3746971
5EKtejZ1K7dym9pJCQWaDYKhFRyz7sqknvngnb6oqmQGFzRX,4055,119435,103005,63858,84649,375002
5Ci1s8UHZyx3sGV27BW9nfbbjKMp9psEoqhHtw9DHWvRkBFz,3273,89624,83137,64090,88779,328903
5DkV7m79skUTkCrfj2q2pTQYkuTF2eNdUbwhTJFgXJwKiXwR,185048,3596876,4701333,3095675,3954265,15533197
5ExpiJceHqRkt3C86qhdXfkKRWssHEj1aTZsUsADhR5Rc3cX,6905,192764,150157,124788,162825,637439
5Gzsnv7pwoGHotf87Xbx1C7tjesPGg1xPJotQ3qiwjTTMDsL,448983,12588443,9706686,0,0,22744112
5F1y88GBYbVE6mn1XMC6RLBY6JfJhbS1GddQjquN3GCWv37M,147264,4727907,3620511,2197750,2868012,13561444
5FKuVosPZvNb5vM3E1a11bQiJP9xLT2sLT4xxJSqyHJrUF1N,52727,1408872,1159166,753582,1003545,4377892
5DiAFPF4NQxEY4E8GUJ2XYPASriKDxPJarzUktXHEVBp8tyB,13240,326106,249146,169763,244005,1002260
5Ea9E12odphyTzE29YJrvDv1Rj9NyxDJd9zp5Y27Fk8A119i,6923,155605,158997,124453,166863,612841
5G9NzzHs7K7e3ZVPAEFD586Y3mtLJnN7RbHqoMSsvi3MDf2C,37658,918980,780463,483010,678470,2898581
5F7bH7vEopHnGTEZ5Cgfy7FTHT9bMfT9tDQvvvUYHFdfnviD,31491,734641,703479,566165,759098,2794874
5CUKRxwRbi3wcNK8DHGWhbMkAdLd2gWi85Lp4sFbhXWQwdrB,5673,140316,117070,74334,106963,444356
5CwUimE8Yswm5HQh7KCJNcVx65LdmTw5GTwdfLXJfNGwbRPW,18070,425552,340042,205615,282307,1271586
5HjkCswwRkSUGNY9RYEqPfnRLAbPqjc2iRpmDeXhPxwVmDhG,3782,144610,81565,62806,87356,380119
5CSCaecpGMWy3ufqtnMjJE7EHjDkXXXQon91SUq2pQeLAR5G,30673,648995,633032,371257,479425,2163382
5EecbJB3UgEnPtMiiHNc6fYsojZJPzhNLD46o5DPiXdnwMG5,29244,0,0,0,0,29244
5HmfPtCVnGQGwo5iKfiXZRTrUwgthRbAU73c2KWtgyyRKHJg,803141,21041929,15285159,10377860,13345301,60853390
5HNFjjmuAiajFTHxbmfAjk1uBAK49qKGejuBJ9coZ8DQGdhs,170148,5008254,3400610,1930685,2918527,13428224
5EsXfSde3b1vp6R2s5mW15AvoTwkNzXPFgmgXWFFwMLJdGXx,560,14750,12862,5945,6631,40748
5CVYVnYYeminVtZvJrCGtGovPNxQsMsiLvbCCSQWJKzHQCHh,1957,51572,44971,0,0,98500
5Ff1ef7zYK2ArhjQePWd5Gk5B8113SZAmRCq1z5pF3N8H7SN,2527,66585,4498,0,0,73610
5EZ9eNKPPiMr2nFtqmxsyiCoDGBCDLSuoLqLseAqpwXNnbMZ,7259,191272,166789,77087,85991,528398
5Dz5GCRFddtszj9LZFcEiRhcjzw9Q97g4CxHQwySNPFrEss2,444,0,10197,4713,5257,20611
5Evf87NYzmuoEUDFJwpj7iX5drJTrG2Szr7tVeKtWCV6HYXg,693,18259,15922,7359,8209,50442
5ECKneewiXS34hNDBJ2HAH2ttJv1mUJF7bs23tdUrmAbH74K,196,0,4498,0,0,4694
5Grg4ZbgmGkbFfaa6kWexUjevke6fjagqQeJY9UQ9XGbUQtD,593,0,0,0,0,593
5ELb3GSHD7ioupPQphw7UJckqSevh524m4m8W9471reGGedj,49904,1315071,1146743,530002,591224,3632944
5GCdD2iGDeYHUHfpKsivgMdFyiBurPCgk6jLHsBWtAeGD9hd,24546,646846,564050,260693,290806,1786941
5Gp9fudP4NbnZVTBknXpwx6tehV5uXTHt7LnPn49piVF2r2M,2239,58985,51435,23772,26518,162949
5H9gRS9patNZczayMPqX91xrCGqQq9cfE4Lj7XbWs8rjRLKL,3127,82393,71846,0,0,157366
5HCFmYDQzUQnTkVc8YYTVx6ytcQEaqBCEz8mCmeFfrMkXkGC,655712,17279636,15067848,6964057,7768493,47735746
5EoEUHDqXz4asD8x6qkSbSbPJHzftZWHHWJ8uQHZiBB7v9WD,277,0,6348,0,0,6625
5GDyxiAxa55bsVkquZGLW7a3X3DvemJZBQLCa3JZKR4dWCSX,635,16734,14592,6744,7523,46228
5FHXZZ8c47YFAmomfL7gAW3QANfPQLHpvS9iU9P24UxEtizb,724,19065,336627,303691,0,660107
5CFMYtvYdRVvzRtXaLHgmVGLbYU9u65US7wGSPBEW4YYg1Kc,1175,30943,26983,12471,13912,85484
5Dhuhds2UU3xgs9wnsmYiYvQiZMmhhRFv513DxEPasokExqG,196,0,4498,0,0,4694
5D8E7DbAGXAARFDopuwRsLtxpCuT8dSaU5xzhvo7JGL5rHrd,196,0,4498,0,0,4694
5HnECr9TRPfRNeCoYAThRbrvsoWyfrNKfwf2Wj2aJXZUPmKH,648,17057,14873,6874,7668,47120
5Dr4B6nDSoj7i3yNd4KouymwGbnVCyFzNE6eSBvVtzCT27nU,588,354175,212596,157565,194280,919204
5G3iRids3NdWyJHF4r6RyJbBSDjLCF5nkfibsQh8F8vBNJSP,489,12882,11233,0,0,24604
5HEKLpP5pUgBvB7ZMTi69J33ZVyWjoabF9y4yhjQj6MgBqg7,1498,39460,34409,15903,17740,109010
5E1yyCUFwBV5omoQUXGbuWxcxF1f4epBscJDLMtEM8JqSYfA,1179,31057,27082,12517,13963,85798
5FRrQ1FThFV1pDndxx9GTkRYAppcaAYj6RUhRv4yNksEs62U,364,0,8353,0,4307,13024
5CanVAW8Q1QqMDMWpUkDiFaSV5vQXnp3ay6Xx6iZShMjvPGd,509,13409,11693,5404,6029,37044
5Cu92Bhqpj5PpVQpCCNsojCqFhgAx5DZKTZMTv7iifLJhm23,109069,2585815,2157930,997141,1151376,7001331
5CFyLJfxK1jcUWMM1RijZo3SConGAPqeKNnopnvtmHAqSV4c,1073,28251,24635,11386,12701,78046
5FZAL423CQnL37bR5oNsm7M6JdNj4idSJJupzz4HLwNuovd7,765,20150,17571,8121,9059,55666
5CSYFgjhj73EW5tNnXxAjh8z3qjivNC8Je6vKbxCfygFN8Lr,1879,49509,43172,19953,22258,136771
5GUDAWHtumaX8moFt4wC51Ek7akpGaVjSeRo5UyQk5iJZbQM,996,26237,22879,10574,11796,72482
5F9h4vPtNwQm4mqz5tYTT3VBhpx8NKYWJh1iunyUKjHCasYp,1505,39650,34575,15980,17826,109536
5DnsybUvYXmFawZkxbkqYRfBtMhK4i2ooaJjofZGxhBgVNaX,3032,79885,69660,32196,35915,220688
5Cw1x1stC7FEFyoBfXiykJ15rZZxR8Nf9ZcCfGygueaqwaHp,13112,345529,301301,139256,155341,954539
5DfUK8SFizcJU5GJCaN2bet9frYg5tAgWyazooAaGCCCGD5Q,196,0,4498,0,0,4694
5CySuhHa6G17CHtf6djHXVKvrY7Q1jWM5BRk4dS89PrGrGMx,530,13953,12167,5624,6273,38547
5CLbFuMKMSWhLPsUioLm1zrMFG3NKHJJuCAHRm4n6mYoCFqk,1105,29116,25389,11735,13090,80435
5CFsQaRXMrTmNtR3ym3Yw92tX23T7hTaZT6scH8SMcKix9kH,2003,52778,0,0,0,54781
5Gn9Gn43zXNLJGsSiP84DpeTe7gB9hi53yT5j6FYJsWVpjBn,601,15818,0,0,0,16419
5GKcuJX2PdVtdSgB8GZXjhXcByK6MSNjxNiEjBMmjh8WTzgS,2505,66012,57562,26604,29678,182361
5EvdVA2Xag4LVARuiwxDzZD3rxnPHLJXJ1DjxEdHDjDomavT,68098,1794536,1564836,723236,806779,4957485
5CHxKnGvMfmX2F8SAA6PVutqbByVgrkCc3aFEr4Y2RX3aY86,216,10699,6974,4255,5013,27157
5CdHBGHCq7azHiLjZ7vCcekFVdfZN7f9Yo1NcnkMDXHxAAD5,691,18196,15867,0,0,34754
5F1M1SsadN5ot77ydqwetNAhLGk7QygcW6kDFmS18QuWeDyS,936,24666,21508,9941,11089,68140
5EqashJ8Nw7Gxy91hmC2JtUBarNDSEWL6HuazTkFZ7UNtQu6,1957,51572,44971,20785,23186,142471
5EedZquV1FJQX5iFANKKmjDWra8e6yDLWg5D5J1MjDMCvuZK,795,20930,18251,8436,9410,57822
5DGAJnTcGWrbouij9bMCvYGQ5amBt4hgcAaobCxASyKW1gGr,1460,38474,33550,15506,17297,106287
5G3YAxsrcCR5HDbui1Tf1WAcohoCMaYDqpyTrRXWgZD6gSi5,392,0,8995,12126,14871,36384
5F4sFigEu2jYKZxTyCVDochqK7PmRgF6aU4qYNQjSeHeZ3b2,9785,257858,3839636,4390981,5388405,13886665
5FvWgJ3NNgrck4Fv2kqqVkxuQ4GqwgdZcDQUdTuJAD22thE9,196,0,4498,0,0,4694
5CGGJhRHod9e8JpS1b3qrLpiZEDzgVx9me1ULUQq36xWvWzt,661,17397,15171,7012,7822,48063
5HbnUYaAss8ExFW5JeBvoj5RhQn5F5cqkiEkfRuhs9KYXhgW,4035,106322,92713,42850,47800,293720
5Fsuruy21FXij5nGVYde8JD6LZdnRmqR18A4D8T16NvgwqjD,2294,60453,52715,24364,27178,167004
5EhCoZ7RQoMmHUEsfzzKf6kRE9TbpjJ6feFccuYEh8AZrWxr,392,0,8995,4157,4638,18182
5CkvtYBx7i6yd1edw3pB3jvFeLBeRRk4XVrgRgLFdjJtipy6,392,0,8995,4157,4638,18182
5FP8BxwVyN9xGB3yCmmUDhd2D22mGwmWYpeavE8nHeW6CgfA,10286,271049,236355,109239,121857,748786
5HpSdkedJv7cKiDSZnnJRMuEVJeAam4YGUeoR8Y9uwWhbpKa,1391,36642,31952,14768,16474,101227
5EAaTVgFccWimpTrMybn2qKemaPpHNerYdv6apzScrDf4bc7,302,0,6921,0,0,7223
5FC1agEDaB28JhJ3jm7B7TNjZ1bxfubzKkAYaufmJesbpkov,196,0,4498,0,0,4694
5EqN1ihLryvxvgZCdpTwffqtjkdi2TPPDwb9F9hHArp6SC4i,1126,29654,25858,11952,13332,81922
5G4BEkSgurRHjXVm1nAw3aj5i4t1npze5WEGLtyk8SU7pdzR,196,0,4498,0,0,4694
5FnD3NG66H3hCaXwkH1YmwnYpPmsAh3XnwpKGmSXLEKA2FHy,1365,35949,31348,14488,16162,99312
5CijF4HL5UkuzCBKoW1KdqFcMXCfjNFGtz13Vnpi5U4AaTua,206,0,4722,0,0,4928
5HRSkM4D1N4HXWhsBDjTFfvfEboQjYyTJSo8obdBzWUcTwaB,1911,50336,43893,20287,22630,139057
5HdUBTbvN7VMLFGPjktqAaKdnjRKozBqavyFAvhSzZKFQQ4B,351,0,8065,0,0,8416
5CaARKEfGEsYKxeE1UbUJaPoFoCSdiXBYio475fvvbr5kj1Q,716,18849,16437,7597,8474,52073
5FHvhB64UcZe2f3yuDRRUKXnYUwdUavDNuhNr6BhYaMZy4a2,5885,155064,135216,62494,69713,428372
5GnNFoyWUyptXZcKhFkPJJoqjQypGiMrSbxXC6FRuMqCBCsL,297,0,6805,130805,175749,313656
5GE638WPrXrmRkQetiBNMbvcCbFaVFs4dYPq3jMiV1sLUijT,1237,32572,28403,13128,14644,89984
5GKYbVDuCPtYN5iC1qzX67g6dfhrNv6d57B4i73yoxag7khJ,676,17793,15515,7171,7999,49154
5FcVZdZFMHpR4o9xf28fDh5tj8oyKpJmd85PVkF9hHHqDSNM,369,0,8464,0,4364,13197
5CabnofTUogFWEBYts8ZH3wstkbuBVqGChBPTKExksKbiygg,375,0,8598,3974,4433,17380
5HStrcy99ncPPxc36D1syXw2FkmE62kPByyj6Mp7BZLJSRE6,1892,49851,43470,20091,22412,137716
5HNdGQMpPrUSWSK5Upqv921Gs9ckCz4qxFCVcaCug2RKLRQP,598,15754,13737,6349,7083,43521
5F2KcLEf26zy6oPKc8anAkCbqorTPhkEHNYGjN54pnrQrXZD,458,0,10510,4858,5419,21245
5HWUUpM5Qz9DYvwSf535VBwyYu8CGgGBNhQgk4ZdirLvGzoo,218,0,4992,0,0,5210
5GRcANmSE3FZxcFU3m2w1MqZ6hV5ZAeRKAFgV5TMb5RP7u2F,2136,56284,49080,22684,0,130184
5DMEqTD57Dz3UuszYQ1wHFZB7nBq3xsrZVG3jL7KcDZNyswU,793,20877,18204,8414,9386,57674
5Gpn5D4pbe42QfuAvBJ1vzx7p4xBkVrFs84Jkkuv4AiYV9cZ,477,0,10958,5065,5650,22150
5GKhdSJuSNvMvVoxTgKpQ8HGqQtFZd1UHw5kdk8P6Ld2Z5tp,50983,1875864,1153308,757218,840070,4677443
5G8pQPdPtmESWM3tLk1xwH8xthx4G2AKaYDJ6nuwn3j2MLMF,12823,0,0,0,0,12823
5Dyu9w7USUwtN2ZUhthuZbx6ZsiSuJDYCcvTx7KwDyaTKbN9,40262,2073942,814993,1004193,1164145,5097535
5G1STFidWBgU9AZqYeZrD4J5FxZfVp4hCr9QdjZ5CWyL6rnR,61346,2793325,1296838,1589124,1639502,7380135
5GRiZrdqgKBpYhYyXLCXRRct17zga3wfkawrddgNzSQU6yRk,118021,4823779,2468289,0,0,7410089
5FA4d75nCJNwqGr9GGiDJZGuQ4ZG7G9BuKQgMJ9PN5ATMjmw,42542,1747757,923350,0,0,2713649
5F22orw2Pq6PDEP1i6iZFdVm2JG5LgT89y7zj1qd1k8tuJH5,16496,750990,348711,0,0,1116197
5CSdZCqvGH5hVABjh1iA7nSS2LoVkEk58WQyqMgr1x8ZfjJ5,16026,776910,338786,414979,0,1546701
5H9KYVMHKtZ4XPJvi84RwRH1mSuGyeV6ghGvKuSuBCZMesSY,108837,4477479,2666602,2328122,2736031,12317071
5F4yhr5HwXbFsvi7TqDinot9nRXY75tDgK4dHt6PXbXhNLxT,21602,1281312,557197,562748,665248,3088107
5F7Kd8eYeX1vRgnMw4jYHr5ZGrdtBC418K2XwvAFvoosxFwg,34289,1464290,884463,0,0,2383042
5GhF5bfWw2AmK56oJTRKox3cmt3ZdRECTmkM2Bv9SXxiQ8PB,7091,280619,153892,150593,210172,802367
5G24MFGcThQCWrL9Wah22cTyY7bUyCjABBGKuxsgEoh4LV9e,141903,0,0,0,0,141903
5CRoB6NGhbJYryjq24LFnAthvJPjjBk2ibfBEMVmK8pYGwEP,40501,0,0,0,0,40501
5D54RZtpHMZ9zL3vxzVb1KU66nfpkpPfxYbmERp9Z9amnvHs,270051,6427722,5589550,4304142,5357242,21948707
5FJ3EJyw42gWXBr2AZotr94hC26bT8596be7pYNgwb8yPwiT,4731,106057,97918,220734,312862,742302
5H8XAk9UUzvNFwv47akb6iAAY7NMbyQs1WMU1fGp1Jg3LAoG,5903,180663,0,0,0,186566
5FkGv2xVuwAFqzrYYujbTrk2LK7NtP3NN9VhmwVvyvnoYkCN,16267,528695,336695,219086,299406,1400149
5D1w9VVpTowjodg9uRSLreFnu18mJ6vF6dCWrYfeHAf6x6Hd,1509,0,0,0,0,1509
5GN3q1gKXaeLFdwS4etk6KcQKy7V7jtzWKjPgu8Q2iu1AsWT,5402,0,0,0,0,5402
5CPu2JSTpcCYYNYjS16nESBSKcyS3sBWDgJQf99CnVLEtXVg,1401,56121,29964,30296,36762,154544
5Ff9Pxe8GFgufoQdbtiAs3gQK8ewyzEs5HiUot3EDNvVvA1W,1756,0,0,0,0,1756
5DRWuGxyAWYFvK2SwWcc3hPFrberFP2zLrF1257Uj8eVpETZ,1829,0,0,0,0,1829
5DtuToSwDx4yg1Fn52LhoSjK67PmW3MWDQ7GSV1DgHXFihue,6561,0,0,0,0,6561
5G42RsrhUktZv6xFVgWuAY9ULKaGhvh4ZUQCo2Ev8GrkQQa7,15437,0,0,0,0,15437
5H6YGL6mK7vZUqestRmeBLf68WEWz9SkLDsgQQbpe8NQrhez,1646,10876,34060,5138,5908,57628
5HKfNTrxoiHz2PpGsM37nWFAk311GT5dbQGhioHCjxiEXAc8,1479,0,0,0,0,1479
5G6RE9ufMLba4x7y5u5AgcZYLs5qzgrvPpPSio968ytx1nJC,11633,0,0,0,0,11633
5DFix7qraSBa8YnsumrT1DpraVc72ePqrDsyZCr7jnMaqEQ4,13503,367366,278304,178307,239636,1077116
5DD4eRAzhojnb1GiRNZAq5wJXBkYEEo9mNs4yps7557sshPf,1412,0,0,0,0,1412
5F1XGvkyNrhvpP4gWBRwZE1RDejohXhMmmAR4fBLBkJ3C9iS,1399,31349,28822,14239,19004,94813
5Dt4ZYZg1RM3t4ThsHCrHuWFiMhbhwXFUC4kFQRJhhMDvgqW,23420,763861,482711,472282,562466,2304740
5CAHNaPTjS8xp7YdFGLiseBVgC8fRJXJ4sY623Zw2ucGURyt,60823,1304051,1258909,3426656,4284017,10334456
5HBzrgTdtrw3XRENAnBLLVVL7unfhKBF946T3SL2tcxgTzeR,10469,150128,216671,122596,158914,658778
5GuRdsWwVoYmrBdABkkT4jUi8NSRkZNuCu93hMsVeyEihQuC,2701,91497,63966,51365,66591,276120
5DexNnxrNrPA3JmU3xz4P4RibcK3M2uLhz5TCW2sj5Z75rrJ,2283,50059,47247,27322,32445,159356
5CMVRDAwPNymueRLkV3tKMDE3oZdWoTuVbt1F5J8KB9THa22,2031,57053,42023,29553,39042,169702
5FxTWiGKr5KNPrNUM4iYH5YBzmx1myLJXFizvcvFgzAJHvAi,2116,40441,43780,23976,30569,140882
5HTaEnGuEhZFSWd4Q3ihoTKbN4puXNp29Z6E3r35wff5gQfA,14660,448708,302159,294758,364226,1424511
5CRuTmrPQNFpxvRVAQXRoQrYEH4GVSMaRcoB1PSPBczsEgPT,2701,82657,55896,54527,67377,263158
5EJGwouCEbexX8ijAmcAYFhS7VtQmHtFMZZgxTFB5c6R2hdi,1939,36610,0,0,0,38549
5GYRiJXF4CXnxW9ENWnRE5R9VdzTZzuTyejQKsTeVYTRXjKv,7645,146162,158228,86655,110481,509171
5FU6iLRSfB1bLyXHGUf1vKwCGKSWH32t2qxfjFrjNxJ1EJrq,1351,0,0,0,0,1351
5Gri29iHxAPMtZU8Km92P3g42ENGhXoME7Prya6yeC8goteV,9859,0,0,0,0,9859
5EUV1yjDatqdifep6WeJ2K8RLRA6aXaGo4BpxamVGKrdxP4H,2977,0,0,0,0,2977
5EFTrd5citaVM1rmVcKKx7LjEY9nhRzZYDKkWDkEYDy4YYUc,5102,97533,105584,57824,73723,339766
5DhJ9gcSXxVZH9MuyHs9w3s3xuv2wYGhkeu6v9eS7KPWLaws,5266,96063,108997,19734,26624,256684
5H48YM1fCTMjbwHrXzqnwac3dZS9XnBaUR79TuJn51gSEUo9,8379,0,0,0,0,8379
5DhtchMdHq1P6YywUPCVJZsLTA9xmvZnR3FA8n4LjUmcPoaL,5714,189172,118254,93680,119584,526404
5Ejy84NfSALPPZUodQmDXhL6mYu773iAkrb7bPLp3z6RWEym,18134,555028,375332,366138,452428,1767060
5CSPDqPsoFeMMeLCi2hPCGw98qEThWQbobeExEfKCQdmWo7J,131306,4450163,3001339,2179973,2637104,12399885
5FHu2S6xzHx1Wet4W7Z5gyXPiWy2onvSjHZVSqdRWUaYS6jJ,3381,100095,64236,47345,66117,281174
5Ei49udcu2851hicAC8imgcn5XUupT5py6u2UZckzKzLdP6S,20827,581558,395791,274795,384161,1657132
5CJCq11LVZuYM8rtkm5TMQiNaHi3rHXLrnVR6MTFCpreoby3,1798,53221,34155,25174,35155,149503
5HTHJX73r2qApD6Z2fryvrpkKHABnyRtXWabFhJMbkoscwZv,7446,220498,140910,103857,145037,617748
5EUGN16HZccErmisukFGeDCAmUyW6r2kwt4VV9FhVdUUo9rU,24252,0,0,0,0,24252
5HE7FdaUxYCV3zJk9fVni72WXCyFoVaKW8yrqfkFPz48iwVL,6500,0,0,0,0,6500
5FbZfgPaJviNvoq6p4yTttiCx1fFc2sV2sLSQgbQ1bZvgnZS,4057,0,0,0,0,4057
5Equ4RRpFBRduTE3QZdNwkbR6zLfkrP3FyrtqMCZwxNawfH9,6007,120216,114154,57840,79951,378168
5FhSXvA1ea83aJhQPLdFKRAsRo2KpzUygCdEKpWwN4PZPY1q,88499,2620726,1681853,0,0,4391078
5ELRsxEXRyt8kqBqKi5Sfj3HsvBfuSzyJrwc5PpjTFyXqXQ4,1692,47226,32006,0,0,80924
5E6tqNtRfa5wAegegh1cqKQRxbVAjVCBshuCMnhN8JPwKfQY,16380,0,0,0,0,16380
5DLQmg7F4G1of1HbyY1EZNY6S3QsmRSZFLwSJUNEzNRAwbXy,35638,808314,677257,395868,515598,2432675
5D9iJuPtg9AUQzLY7cnFgGCrT8WQihEUPSjUbgWbfBbM44Tb,4261,88350,80975,43938,61117,278641
5DXhcoJupbMmtQJzo4syJPqACPKP5yT714pXMc6JHRUfr4af,28116,832580,534309,393810,549957,2338772
5FnWV6GYKidwLx4KSDhEqbZL3RT3JrZfZ6s6dghy2M7895yb,19542,578695,371378,273722,382254,1625591
5D1msjdbf48PA5mdV1MuKKkd7AKyvURBkFuYxh71vzoe5u6G,13521,254871,256944,120972,158383,804691
5CkDW9qRqupYoJci7ALuJr5r5MV43bHHsgJ45KPVGJ2GWhwi,2890,65912,54922,33463,43280,200467
5Fy7411ngzoYzCDoHuk2M4atAQ5SoH3Mf4wfAznzzwW1oP1N,1376143,38115471,30120991,18610185,23814503,112037293
5DLV7RVNDE7pEuZ1i6pa3kFnpiR1S8dtnRfYN24h3BkhSt9R,151736,5009504,3720325,2127542,2918229,13927336
5D2EKRs4XfCYzmp7ZueVagABcbxhf8TESt1NkaBtLVgn6Vg7,371804,9833155,7804630,4914842,6502738,29427169
5GYffRvcdKb4FJkShttGUxTwWQG3skWAvAsGGHeH7MyCEX5R,14873,429134,306275,0,0,750282
5CoiDNKJwhbAQLAhRpuNT9jS5nUSiVKYTmfn6uUKwbwrAE7M,22981,731398,441498,366076,465671,2027624
5HKcyH4pNNFPJ1JLBRxK6VsuSSgAxjXEFp5voqkMS1k3Jv5h,15137,535191,290794,283373,383189,1507684
5G1uDLhQUx9ZmPkYMVvYFmS9BramhgfAcUpBJD2Z6QZS68mV,28944,1023396,0,0,0,1052340
5HTpxqwFpjYHwLr5YeM3Ktqxn2NGEmKFMi477EDggXWMoHXV,4755,112827,91341,64953,83514,357390
5H95APHgWihPdcxw5PaD8pxrWh4fzANju9tPw6Zmpzq3Fvxn,46179,1030111,887172,580568,897762,3441792
5DRW9CexN74DbFCm4vch9nzjSk48iNGWnLzUHzxgXCKsPVTp,167282,5166006,3112399,2301212,2787703,13534602
5GNLSJdwxw5hfikvHnBJTLfotZP5y3pjnRhpcEksxRe3K93k,55336,0,0,0,0,55336
5FnJGBpDnFAS2kqb8rhHDzpW6n3nLqVA5rtqJrAyBHUdYxUf,43465,0,0,0,0,43465
5CX2L9BhTDZ6dtDwVntyL1MzeVTMKgXZuiDA8B17wG4bFAux,290212,13133227,6239252,5160073,7124441,31947205
5CcHcZ32yN8mA38y2zGG9eCqKPLT5gTMw8N1BReWTTf2DbAj,793745,35007824,17306984,16486408,21827771,91422732
5D2DJHJmkGK3c3waAnGYdh7RfkpTSct1n33rG4Wx25CN9wDb,748752,36296730,16337508,16903115,20952229,91238334
5E78RWdcF9LtsMsSGbu6NhUdy4Hfq52b6LtKavjmFgZKjbi2,139030,5934764,0,0,2407196,8480990
5FedFDQ9h2GqDx74RGcanFSbgGKoW95EpVFgbi2oPj6CwUNj,20447,688297,407002,382438,501380,1999564
5Ey8dCTd3wPM2VnBJnCQnwu56nBps4nSEajw57vzv9iwpqgj,57867,1890542,1060588,1238985,1496150,5744132
5C7xSNSL8mnjk2WwPPPbHPchYRBmRhzzhiuWGQDQuDYPs3Wy,174453,5758396,3209142,3079129,3972588,16193708
5GNo4j7rCpRz3w3du76etP31JhqTyakBbYvsmD1pSoR7N5b8,120363,3642635,2395933,2127803,2982751,11269485
5EHMqi641a1Vq9S9spNvuSxMoKZ74KFSZEGdJrnDvup6duwa,50443,1076648,697734,921992,1273223,4020040
5HN2uttgzAtULJQ2dJ3Yq9AsjjCemrxLvdVwGEorj1JDK2rj,19343,931592,354519,403521,526256,2235231
5HgNc98MCgTbizqA24FE2aEiG2wYbRnxNfX1R7GsjWwNi5mg,84872,2033639,1571472,1526877,0,5216860
5DZVfPiBYej79Uq7FJU3Fbm2CUPc6d4VRXB6jsZtNdKz5dQe,22839,1137803,0,0,0,1160642
5EZeTwx6oQTwPviR4AzkcQjCUTagzG5xo1RYgtv43L2tz78j,31047,1439486,732846,620327,701642,3525348
5DXPZseMMWv668T4o5JWfHsKAHV2JhM2ABvV5gqhikowUmNb,77156,1440028,1538916,1266420,1652487,5975007
5F6aYsuYMYiE15gXGECnoF8qZNFofEYoDKGGNgZBRpkvXeUx,43831,935517,606273,801134,1106325,3493080
5F262PE9n8ZnHinzB1PfpRGBiJ5KVb2Kx6QXYVFx71EjKWvz,6027,119035,83363,107474,152119,468018
5H6rggyghnocQJbKEG9KhqDkYMQmzmHAaZJfu1rdVa49rktw,167148,0,0,2250390,2853088,5270626
5EUwezoxWYWWx7TvQ6qH41i76ZJZyp2eHp6WGaC2YucnL1F6,5956,129227,98519,56538,68166,358406
5DhJzPSzsyc1RozRiKHDenfS16QG7uAzjdq6Pz52Gq43M4bE,9965,343622,164824,145505,178441,842357
5F6pr771BxEqRvjGCyaJW857AWZPgjjSDCaoBrW4UA1JDotu,5799,125816,95918,55046,66367,348946
5DcSL3k4h9DTcsoGiKS31uAUdwFv4BYCCg8UiNqXxTcqCmCk,3322,114541,54942,48502,59481,280788
5CAya79z754AFm6m7AgbViKbS4bYDfh26FPMPxkbbekeRmPv,2628,38393,43467,26539,32280,143307
5Ey1zTJNGrqe2Kpa3iwZRshrCTnGXeduvK99wbhdNKCYEyF6,3552,122477,0,0,0,126029
5HmtJ7yDAMVfvxnkXb8Ks6HbDpW7fmZ2CkfaeS7SHUmRv8vK,416,0,0,0,0,416
5H3WwjnGvdPkiuGU8gySjmdaLnaQV9Ru5ayScrFU8grpvEqF,416,0,0,0,0,416
5FUFzTAmM2eZMxpjuMbDF1N2g5pZKmi9a5d6vrnBjVv1RyLh,416,0,0,0,0,416
5HGmgxmqVi1nAjrs7LqLn7BEYCZc1aUVtbakzsRaaL3U8HgQ,17773,612891,293983,259526,318271,1502444
5E4TfPJEeLydeA83venxYeBTorBkyW39RiKdXxd4afU9VC6v,12049,261419,199298,103023,124213,700002
5CANDZV3PfFGAiDH6GH1cAvsLH4tkE9vYjjcdRgyw388Jq9X,15069,326952,249258,143044,172464,906787
5F9VJ1SZyy4mCUDE9G7B9kQyPAHwi4vdbraH9CMUa3ej9nHb,2076,49965,34339,22502,27619,136501
5H95DQWCoZupgGQ57yxfj2W9qdyoGxJt4evhc8E9yup17wKh,1993,47947,32952,21593,26504,130989
5GpionxxSeMWDzTgMV77qMofcnjc8hKoa2GxSnNr2kyGmnFd,3978,39342,65793,21177,0,130290
5GLRYj4CpktqqMohhMcMo1zhWnL75sDsVVJobWzZj6uqzWe8,16337,354464,270232,0,0,641033
5ChRwe6PQhxpxSYYfC3XFANo79uaVTTGntR1ieMWXLH8gNkQ,3420,1345065,633797,625934,0,2608216
5GnRapfLoD2CmBdgDTYBNKYuq7gVX73DMKciMgjTHqrKKqMi,906,0,14972,0,0,15878
5Hijig5o8JqyWNTbryv9gvxT5e5KR2tCwxca2iqVid5aE5or,424,0,84202,81477,106814,272917
5EsUngs6doNjt4nsPTjKo5KZAgYQtv2B8z83GPhor5FDoeKz,1450,0,23981,0,0,25431
5CUPsw3TVQUzzATtQavi4HevxDnsnAV5729dmxzsYdggnDsQ,24732,593888,409105,249779,303816,1581320
5Ey2NjDcWcWaQBg7M7nXozEz1vGnmbBfBD3FmS9nNEzxQiMY,2763,0,45697,15259,18762,82481
5HSxTyuBqu2NmRyFE8atz7Zy6uiBEw9Uin1hxn9nMGg8ncac,831,28636,13736,12126,14871,70200
5ECpb5frEUGpY2ZMKEgw553rgA4hVe2VruZsdUwXUoCsAFrV,9659,4774712,2127429,1828864,1723766,10464430
5DymA82xGK63EavYdfkNLP1Ry1GF9fWLuyUAXFjeH6JnCpae,8338,180911,137921,79150,95429,501749
5CCtMauq64pma2zqc7vg76bGVE2z8iABQKsJAkCbweTNDyd5,4933,170091,81587,72025,88327,416963
5EFJmjuBZNv3fJtkJL63gpDo7mRLCvF5qRV1WNDZkZ7cUkE3,922,0,15236,9984,12255,38397
5HatHmCQtwQFGcamLUt3WRADmzHkY6Y49JrxWDsUAK7zMLJd,25038,543247,414154,226322,286558,1495319
5FLYbVTuDYqE8RiVJCygczYgfMhbYFoMs8w4SE5G8KiGdhqw,416,0,0,0,0,416
5CtPsQRAFtCWAM1DH8f1nmEQvLsLWNirHnmw5Xk6XqoW8gMK,1279,0,21152,0,0,22431
5DfHi4AnMxTPa8CytPN3eCkqUzYsMjH4KKyoppNLKovvvwC7,4655,1830720,1025198,851937,81912,3794422
5G446rQb6g1w58E2F4MTU1z9k7ycjCpN6ZKoJYk5YXcMnCa8,1661,57271,27471,24251,29741,140395
5Grv3unUsQFzAGKZTxzkVUZaaRJtxabHtxdLywwaAVs82p2t,5726,197443,94707,83607,102531,484014
5CZcVeRKJzTfBMbyhAkUexAmbNFHyjBUgr33oWXdjMyDDap1,646,0,10683,9431,11566,32326
5GhQDsUkM2J2zzgLjEtpq4ndceEgeRShPmEYTZ3yUVadcJsA,2377,23504,35139,7930,10588,79538
5EvnbNAQ7gcAEgjVq3ZX7x8jfp5zXfyZyWMScb7yATRnZjZm,490,0,8090,0,0,8580
5FgyhSnRKwou6pMvWBmeB88HVntGdcGFWMFEHYeTMhNNpqtV,25953,619338,429291,302575,364955,1742112
5GWrRWhVayF3ExczfkazNKFUFoD13QRsn2HBGUXu5M99qeJE,469,0,7752,0,0,8221
5Hdk8BegWyPt73Lo4Qew4aUkWL8kkYaVPEYrV43mUVsSemo9,1249,30040,20645,13529,16606,82069
5FJBcU2Ufw8ciLy2gq5kpJQ5vDwYuqqcpUeZ1sg3br6rPxiz,1253,43194,20719,18290,22430,105886
5HL1mEmX3Fq9wieYdsFFMja4bUn4vyLUMPfzHFmGfhs6TkUC,3565,72502,713731,405388,556338,1751524
5F4rdKvFF1mF34Czt6Feem5twEtEN1QdAme3Urq8SL6ggp6f,1343,9781,22211,2302,3462,39099
5FhbjWAfuGtc4VnX8qW3DKn2amasCFZ5u5UfBck8xCeB7tbS,1371,9980,22664,2349,3532,39896
5GHeZWrfoCjQgZQBAqKroU1uv6rB2PNkGFa71XG8GkqiXAZR,5562,154726,91995,67458,81977,401718
5HVksJja92WAgqFw8tXNeSpjnYpYqRR9s1VeAPTeVREgWs16,981,0,16224,10632,13050,40887
5FxNxv7LSqZ8AaYeVEWRPcFeHjypaWSifc51uooFyjRSXBvH,1274,43918,21066,18597,22807,107662
5Da9nAb1hruJNsFLTz63ZQNWdecVFKyFtfWupgictKy8qJZ2,644,0,10645,0,0,11289
5F9znMfiqC4fNeoompq5MFH3awc78hoo2ptkitCTH3vUUPBK,4431,96141,73295,42062,50714,266643
5E5FVfu1Pvxvr1zSEkbkrXdJwMvYZ62PZa5TkfqoZtquRm6F,4983,49280,1013741,762418,1077038,2907460
5FNFzQHJH7qRS4gTjSo8JN7xiLHpz1MpYLXC9R7bS3KHF9Mz,499,0,8242,0,0,8741
5DPBjvHGikWTWbQwQ48HTysdnUZ2QqLaPKL2WwiPo6kNRQhG,4152,143176,68677,60628,74351,350984
5HNkXvqJ9b9Fa7LJkuPi7Sigqana9izvz8zPaBkVQBi12U5n,7502,0,0,0,0,7502
5HmGjEo6YTchPA7uJcXUfha7TGo8cgNC2C8KQ1BgY1Q13DHe,1422,34226,23522,15414,18920,93504
5CUSJ3aH7xbZZebEAdhLv79eEeQZqGGqzLFPXzD7xQodBsaF,4323,103795,71500,43654,53099,276371
5CS3kUDRAPhK5AucqVTNrHpHPpFCRZjh7wHeRu9kkxYwviuG,603,0,9973,0,0,10576
5H3iHbQ5VYLwVHu3z4Ui3yp3tGuzmxkGxWyL2T8aA8prPabB,1412,10283,23351,2420,3639,41105
5HZ7b9B7eN1cFuGBGfByZKy7pdVdJcqSra3Lz9u5XUY25A7S,5030,173438,83193,73442,90065,425168
5CV1MwfqBZztpjJTWUh97JwywhRZKREZ52xxuMgEjUnFWhnn,9734,211191,161006,92398,111402,585731
5GUBg3RbNFbHPTNAttAgShUhxACYJ7H5PnewWDytTeJTXSEz,2354,81167,38933,34370,42150,198974
5FFCbGUUzdatNxvb8WByttjuv2btpaqrtmRVYH5ZMyAEQVYs,436,0,68228,74824,101292,244780
5CSPQYyWAGPdwEGueatPoEQmBSBtkJao4uRLXww1Ute7sFvJ,2440,0,40357,13476,16570,72843
5EkBakQ9nVuN1um7znJHDQa53WPpRsrLHXwKaZJ2UMBC6hs6,654,0,10807,0,0,11461
5FCK8w3b8JiEbi2G1xiET31jdefyTeA3soVqcNrDQxNWRegy,4684,101611,77465,44456,53599,281815
5D774ji64F7EDA4WqmMFEHpGiNpoXT2YwmZW1vnsMjT6CGMG,2288,0,37836,0,0,40124
5F727SuRrgtDZkoanV6aHc5ehEJgM3aG1y1LpS8jYQgjUGZx,1617,0,26746,0,0,28363
5GpJ3nQ7bRP2SGyFntojQKRn8SYcZudccaz63QBXb9E3Crv8,10861,260786,179644,109682,133410,694383
5FemtbuDzsTQeKWD6zeMPacfsciTYZL5djo6CwNK6MLaD543,472,0,7805,0,0,8277
5Fhig384hvJbLob3uFtZeCvtrAcKDsuzPeBmsfc7uhKjbeVR,1828,43975,30222,19804,24308,120137
5G3ec428Cr1oyMYzopUNvn1V2hgxe7hSnTwYTYjpn5Qirbt4,2866,0,47406,15829,19464,85565
5FHx9tiyBprpnXpLEMTMv9MFZtHug7zcuVGqyJGANJ2px2nj,579,0,0,0,0,579
5GWgfV6b1LpveHygALu8SRkm8jaQrnPd3wQpU2v6T5uABZ1j,2927,0,48406,16163,0,67496
5CZn48NqFUB9MxToqzMrUvcsAfp6thif5m3aNQknrjwY9h2i,4163,90324,68861,0,0,163348
5HmdHszVo2AKjHMRYCZUx4fiH3MUgm8LZ8518zrBhYH6QCkV,432,0,7143,0,0,7575
5DcXTk2WLmFcgSVuhJqgCmFygSNK39Tu9PjFb7kfre15RSsX,21550,743146,356462,314682,385911,1821751
5FYw5UjZtwe9yXqvtjdc8RM3mUuC4ewTUhF4ueovn78HW1qB,570,0,9418,0,0,9988
5E4xKpafpMHasWfMpTXoXmujHHiCco2EQbRmUwr8QFZ6bcjM,692,0,11434,10094,12378,34598
5GN7oxzE31R5FxKJVoN8d7bC1Wq9tGxJknfS4F8NWLnxJwA9,1898,0,31387,10481,12887,56653
5H6jrQfLNfzzA6PkHSysh7HXQgcrRNb9fzhb6uKWioU9zxeN,4387,151263,72556,64052,78550,370808
5HEtecNmXXbrgcuiXjKKjf59X44aAw9W1bhAE2Ymkz46AbL4,2188,0,36193,12085,14860,65326
5F43SFhk5wGh9PEeLHLs2cPtBpreXYtPH8r5GNugVg2Zxj2m,1801,62095,29785,26294,32246,152221
5DcFWpzGk99mHpqjyPJedvEWixvVLNJFjEsTg8BxmESrkHzV,20759,715879,343383,0,0,1080021
5HNNcuagWYdexnpp4o7XNkqz5eQLbgoLasr1PJWytHqePP43,3027,72664,50055,30561,37173,193480
5CwVQXDhyfUAWh5u3sBeZVpFxm4wG63RhosHvsxB3trxfKk7,109578,2377559,1812575,1040196,1254141,6594049
5DvjWCgWBXmtEDNFcHh85SBMATk66irhWYkZJAGBZUvFunFo,2685,92570,44403,0,0,139658
5GBngyG8dFhsYmwyqPCytTcEqH93tmHGJA27jgKRoULAbqGs,482,0,7967,0,0,8449
5FyHHQ9Fog5nKWeEta6HiGrNY6rdJ1Kt1yBEiiK42rug915D,484,0,7994,0,0,8478
5ECcNoqqGpRyePq614rqmtJRX4EEVKstU9EWew61B5kbQAc8,6694,230845,577080,685470,0,1500089
5DRPcd3kZ6tuALgKxf5cVP3KcuAKcoFinu4aCxRG9S4cj1Sc,1631,39237,26966,17670,21689,107193
5EXErHGyWucRg1LCB5xmYksoVmnxaPcHX3kYqkQwipK3ZFDQ,1578,37974,291813,253089,302758,887212
5FnY9javasWGXcCmg9XkkXkkd53CVHip9vHNwm3ZkhSTobVm,440,0,7236,0,0,7676
5EyVUYkpUjVbJPYurGin76nAcyfG6MiEoEPMemyd8orChzMU,12903,279946,213422,122478,147669,776418
5D1yq7m2U2ghc83MBjReuyMNyzWVMYAXfTZv9ubQ4gbiTCYT,478,0,7904,0,0,8382
5GZQN3QnqpLA1Anbs62kmt8HpndEMGJmZMFhmhBPunDrZJP4,9908,214976,163891,94053,113398,596226
5GjZxzaSScYkKLzVDJnsdyPz2KrY1zBgYduCq5bkUrqKEg23,8304,286352,137354,121255,148701,701966
5FLQu1RKdMjjNC5U7S5XxqN7msSA5XDnWSzWy4i4i7gECp6B,2462,0,40725,13598,16721,73506
5FHM91D7cy5ZPRbckaWX8HgRP8A5BxUYQNWbUv2gJD2xzXBd,419,0,0,0,0,419
5G7Ck8V3groexxVdxN2TUVdStAEKPKJrrTimJjGgoqoi7UX3,418,0,0,0,0,418
5DcFH2dt9bvt2PawvoZAmpMY6zcMXKz2nbm9FzY7kgYTdWQV,33695,1161974,557360,0,0,1753029
5CCqLThcanJSRCWqxkWpAdyPev8jLej4bKNPjkSHU3UQmgv5,4923,106817,81434,46733,56345,296252
5GaxcUJoz7a2wgrZ2ChvtwDjH8c2LNVcsGgZzFi2EK4yGQeJ,5398,117109,89280,0,0,211787
5HmqE4LqXPzGgtvBEDVo7DkTN1S34yNmZjagaqz1AToQ2TZV,457,145941,80091,63896,84996,375381
5DPpyph4EZ9wcWB1pscZW6xrfLKPsqnBLvWbSRndBBtUda5W,2159,0,34396,11925,14663,63143
5CRpXeA6RcAWPXENkaejRGeRpdjd5inARpKkfqcW5MjEFSMV,860,29655,14225,12558,15400,72698
5EEdssxLhwTSxkSTQ7UPCW7h8kVJGMdexu8AGdm5wpAFzpNE,422,181676,92882,79574,97950,452504
5E9x2sLNGLdMnzCNYB9cqdg2XycvS7pN3w3id6ydns3Lh2Bt,44466,947006,735528,371352,466577,2564929
5HbY3uHLRV6AjvvCyKZauET94GBzh81rUDXDGvMuB4gMVagr,1784,61508,29504,26046,31941,150783
5ETtmFy7iVtCQRZ7P25JQJ6Aj8VhaTWivEKvfrGST6dPdbgb,41983,910916,668861,201472,242910,2066142
5D5GqymKyc1NjByL9ChdSbL5tpgAUw1V51DRw7GiEv6GKq6G,5389,116907,85842,51148,61668,320954
5FsGsrQ7dd6AguC5VPcHxVdTKM3kKoS827QLYse1gkkDC52m,831,28636,13736,12126,14871,70200
5HbmawLYGnDYqNMg8bWNnfCC6wrCAZnDspMbS4boyhsWmDwV,416,0,0,0,0,416
5FgWPSiMtfuCvU4ah47ZCY9fPE5M9TLHcSMGVmNuW2XwKG9A,1391,47944,22997,20302,24897,117531
5HSo1GQAhnnH4u2XPEjyUXjFixiaCphYzQD2wzgaGQZ1vTqL,52136,1852937,1028033,667279,822646,4423031
5DAenwfJbN1AnEVHuUdcV7JYzrRmQpSTbQSiZ6bNTfi1GSvN,8145,318381,176765,203863,234636,941790
5EEs3wLtSW6E1FkWGQgpSANFfytgtQuFpUhG3srKoripuR2j,34718,0,753463,931765,0,1719946
5DZqQTeg6LEvvJnYq53jqBNGAQpT8iaJEZRaNW7aAiwBn8LB,46263,2486574,1199594,1563509,1519246,6815186
5Fq7Uek8FMAF5fUroxFfiuZcpLGBFg5U1x4wjGhidKPL9LHj,38900,1176700,844228,779795,1046770,3886393
5DqsJX8UqRcvEenYhDwNkXXSVQ2MdVmDekKuba4zZehGuixe,26064,775149,565647,599804,0,1966664
5CkPyZwDPTwnd5yU8cM6Fp4usvS8ZBkgTzz5hSKf7BshJ4Bv,32954,0,99231,848109,827737,1808031
5F77HNVWcwKrixXjLwAiwCPCfWGccjgYQjtLwwmYQjyFcFah,5249,239967,113910,131274,174281,664681
5HiogEg7MPjYjh7sNLbjtBmLg7tVo9ZwJJsxWB3gqjTegvCt,185579,7560505,4027531,3615868,4844532,20234015
5ECnXZUcPMF6eY5hmXL8rayMj3FzNhYqanQxL5R1mV9hfmP5,3258,120548,70706,72688,100623,367823
5GKW8iD4ZtuEP5LH7G5cUAnSDVhtyi45UVxhWzoEQMJraUAG,9785,0,0,0,0,9785
5HnB5MbbAcbVvGQqvoHVDa5r9L1tyCChSGjKQ1awNojRGxb8,3370,171172,79577,0,0,254119
5DfJUiZtxKQqemMFykGwKBxoioKR2NnacQgrB2JVkd2Mg9U4,46263,2056300,1150686,0,0,3253249
5E4p4e6yoYCc4dnDztcuVo6uHT7zZMpXm19QojB8dBaw5ZPq,13277,401596,288127,266136,357252,1326388
5G1xEGNcUFdYzyyh41hGxMuG81BH5XRKwHQ6EDp7BsDQ81a3,6067,232692,131642,133500,185474,689375
5FhT9o1jEtKHBnvxbm8YCqbaVdj6bDudnvsLEezCWQhL7c59,482343,16463185,8691078,8833834,11555575,46026015
5F4thUDPTj6LFnuNj2HHERThKyrvxe5KK9zuRYi5drMeQJWd,287325,12708486,6935161,6189466,7634144,33754582
5H6gvazhbaDuzHPWsnmXRy58rafY4dGJFCvNbnx3fTbV49z4,130445,0,3078600,2083240,2650664,7942949
5CmBh2RCWtxQP9mRGipQBAFCcqMa6KLnaqv7eXcNx6TPLRX4,4664,223989,117829,105002,147488,598972
5CiGTW1YB5z7mwL2a3F7Pp8LorQNJKgSUVHz5Qm9rNB4JMhL,170832,0,0,0,0,170832
5DyGjdbNn4VD99NKzh7RnHxoq4WswBiXvnzsFhXi8D6CCcUt,18468,841206,466623,494736,595052,2416085
5GGzU5KfT1rMu67451RdVsyiscxSu8tqqe2RnkRGLmq7GVjQ,62736,2888022,1605982,1284782,1799240,7640762
5FhJui93qjA61NTjvbEyh6y9v8AEEpxmPXf3hQzSdgH2vEHw,17525,880548,442788,224823,291700,1857384
5Et3HBRiCPJxeM2E15tgcL2Kdm17GqvU9aQZZ7PzpNdF3Bpk,127577,5272728,3505338,1998037,2660074,13563754
5Fq5pjg6KHbAziAXAw1JEUs1ETPh4mqwd5Yw4rJnPmgAsZtL,21285,518632,426135,415925,420160,1802137
5Gn4Xy1Yds1BJCDhwvCP6rQHDaFebWKm6EuQpqmtBiz9FaWz,186991,8069601,3743781,886927,987772,13875072
5Ct77HAQMk1WPUcEg7k3d7WjgGYPqaMPTdGiZSsgkJtVn8yn,21204,0,0,0,0,21204
5ER9BRRKemRen7u2rXjXn2CggGZrxGSXbEGvBhxB4mpCustk,18240,719119,346072,372331,474359,1930121
5EJ2MfzL8JwzZrmoddJ7y6Cj1MtbCH4sCyw5QGjXykwKVffy,4084,154349,81758,72489,106449,419129
5C9xcKMWeJRo6EUv5tyCuBU8R52wc2jtjHMX5V7F5AV6d3jj,80949,2442224,1610130,0,0,4133303
5FpZxbj7EPgZYatSQifjx5BRPYHKc8HWAFo7yu8WVcht3F6N,77926,3310366,1560167,1472082,2037924,8458465
5Cz6NsxakCQPybrXyj4AGpgZ9VK7xztzU33HjGTh54RRLkqo,38324,0,0,0,0,38324
5H9UqUHuUzNFTQAue7yKdGNw1KXquPusntgT266XD4m7n961,23961,1102766,438932,544909,731319,2841887
5EnA9dPSSdJAr8AvuarfH3UF5VFmMRMfW4YBBGf4AJs7ETz3,162057,4314653,3528397,2375828,2391401,12772336
5Dk5g7dYxY9wskW4vLjUhDv9M31qEFDN3AFPqJmXC5SmLDDr,8498,223459,169444,218781,288847,909029
5ELetVzA4KFmbA6R7Z5iqsCbx7bv9WjwipkCdfBDVXD17pGm,24626,607807,518840,860785,982186,2994244
5GZLnHq9QvrKG4qbeGQhuMnbLk48ViShWo7exFrgHFSaFHEn,1788,0,0,0,0,1788
5FbxCYDe4vVXVaL6xLqtTKpargSAeZT4GAPb3U9cxGEbZ383,23237,0,0,0,0,23237
5FcRnGDPGgA93HEFYcQVHRj92NxVJFwYmDgBaiopVe1b1oE4,4060,120839,85520,98655,0,309074
5Dw8bbgb9UuUbcTXQfzjaJtpzeDaQdmdRwbtwpeP4czmBtkr,5612,660129,287067,274485,356994,1584287
5ENwXHVxGXisNc7edFh6osodnSKHLDq7RonLZUBy1LemD7B9,36673,918271,772642,785947,1120944,3634477
5HT62fL5kbeDPppRyZQjSnzZM345cyR6wgn335xYno6tQ9jj,12804,279902,269749,327280,443219,1332954
5FUBbsNB5u2a5m7pBy4fTXFLEcPwhofxFNVL9KYf9gVJLhwc,8646,176596,0,0,0,185242
5D9sRVUmkkEYATXewUzcJYgoJDSdb85MKyqARKGeHjhQrG6K,7875,190704,166616,196261,260619,822075
5DyciFyDdp6SrDkj4cA8oteFDoLztLjyzdskXPg2m62dRH4e,1788,52576,37819,48658,64698,205539
5CDGRyCm6j4XUwTeKYVChYAv28zw2ywM7e9qyasMSnBS669P,11362,275135,240382,283152,376003,1186034
5DWej4PoNqyYdhKpqJP2xeyiqWMGWseVhMWqCFuUPtH5wm48,64621,1718476,1367217,1594867,2114206,6859387
5EWeCsYeKHxjV2gm5LS6o6zVtrVaE9naJX9TL7WBsxVNzJG4,125122,3157308,2505443,2997344,0,8785217
5FLNkcYLkCbFgQBrmucwPhNte7LB7vMW5RDzRp9hBXwbThL5,21273,625712,450083,579081,769981,2446130
5DHX8dDuxM36S13Tf9DQSE4vUphjjFNbKeDpVd6ZnS5Pz47X,170989,3733745,3192172,2252295,2574851,11924052
5GmjCSgnboMFhqFatoesekqzmF83ysZjzkrNE8StT4EHPr2J,555,0,20219,0,0,20774
5DfMKU6jwHQpUWVQCrF58Fvxq6ENjdmeKUJ8H2d5fSmuFSDY,1124,16515,41003,0,0,58642
5HVhJpp4KHR5Ds53383LhHG6GNE8gpqbgpf4TJpDqMXon2Bf,2385,80703,87000,34220,44266,248574
5EbhWhaPzYDvLvLw5z7qrAzEE2MjKeZ3phMNh1D6qDJw4LrU,1592,23387,58065,24470,31019,138533
5HDzRCR63Vj29oHNNR1m2JK8rezS7TLFNQsaADbzwhKFcPbP,5426,274551,197949,100414,131811,710151
5ChxgcHQYzM5kiDhqmAo4UhLxVD7PmKGA3pWQZ9TbuqQNt7F,724,0,26394,4222,5020,36360
5DRnZUi8GdXhw5XGJv9EyPdrpGAysmPYhaznAv2GaYxaF1pY,659,0,24016,2674,3529,30878
5GUK5LiRvN2y5TFahEEFuGLbiaA5DvHE5sMtSqCixEpssgAQ,7468,402984,272465,253432,335719,1272068
5E6o4WeH3sfQ5xzobqbDKxmtcSTAMqutiW2shCgdLvc385Vz,5478,203632,199850,83676,107511,600147
5Ebq2m8BRAFE3zBU72JQBhoiNV6cGoYJxrJZEX9bkZvdEf9X,1771,26014,64588,23675,0,116048
5EsmBCAgnCwPFgpFxdyyvv4W622qZ6w66xoFELkfSkePp56G,1517,44410,55328,26765,36149,164169
5EPXs9vPAKKxicYNmKDptCtmXxZVQTHezwL59BU4Zx2fMWM7,949,7900,34600,5534,6580,55563
5EoFFqmxGDFW8S68Bo4Mdidaig5iRuMSnpLGNQUibdb3FpaU,738,13196,26896,4302,10222,55354
5HbqvJSGkDakr7aC4vwA6Uh1crWWxCV3RDmDMLR6bFHEcd79,4014,142729,146441,61314,78780,433278
5FA4Cj4xMVvvVCEZ9kvwgvXmKcmK3xJQaX9ZSEhefggQZsat,5004,186005,182550,0,0,373559
5ChmFpiXmCV6KpY4G4m4UCKfB1MvA4eUsRw4PpYcW57xqjRH,702,0,25607,4096,4870,35275
5DLdeGo7mhbv1GiKXCoP2tuS4xLZjGXZThP9vvXdTtCfLTpG,2326,195657,84861,81240,109327,473411
5HgCo75FtfNUAdFnu8dWooXSuun7ocBfLasByCgSpMFbGNsN,20589,886932,751184,373377,0,2032082
5CzSKoDdx8CjB2BNVpgufuMgjGFhYfupRMHA6xVu5KoyM2q4,849,7068,30957,4952,5888,49714
5Ca6rugTQiddFpxquLmtm2u3PfWxHXkLszN8zUm9ujtH9akn,362,0,13197,0,740,14299
5Gb18SjtL3zkje6GwUcDtRPrv1HJ82JbmuXwC1ARHtXq6tMa,950,7907,34631,5539,6586,55613
5Gq8DCU95zB8bYMKdEj32B2MaGeiQj1W3uKii2tkSZ8YZWZH,697,58626,25428,45186,55900,185837
5GswCpdKv1Pe1EHq6CW3nC9HksGYphBgTxgGHS4boqPBt5DK,999,70194,36419,28552,38535,174699
5C5a6Z9Rcs4ZHQwfaoEK4EH4xtTtyXmPo788rabcjQMt95Uz,1817,127732,66271,0,0,195820
5GbBXKJp8GrELXSCE1hTxrW5ZFFVMynWx6xQsGX7TBR6pqVK,912,76669,33253,31834,42840,185508
5GxLKqj6kyXHHaV5x3resk1cU6gXj276Cx9U28HtYdsaQxig,2865,96935,104498,43753,56216,304267
5GjY1BZRPq1B1R937mqunGt6bKn9e1RWu9UZ9puyiJCaeBhp,362,0,13197,2186,3648,19393
5HBA6YMjQiy1YpBD297JWDmGNnVDMSJFNsqz4mApy9Txqrrc,431,0,15705,0,2987,19123
5GggMkGDTvVXZ3niqNzmh4c9xPywnpKRjj5uc9zYVqYkz71c,726,10590,26481,0,0,37797
5G91x7ojpDyHKxpKpTX9xLCDC9PF6V3M3HFhdNVSdq3FGFnY,463,12433,90980,67430,0,171306
5EHtaUvE3QADjmn1sQfseHANmDjfZkzzLZkme6V4Ba4Rq5XL,659,0,23933,3828,4552,32972
5HQM8VfFuqmrBS5ZsxTxXz6F9xf5efj6QQawuLJP3PgJjcXj,1201,17637,43791,7004,0,69633
5GTZY1BNiTXykKLbiJkQSuZc3bGSjty2EqwUf1WwAhYFcDwD,1927,43823,70293,25766,0,141809
5FkRX3rGCNnbhzeU4tBqptrwxcWLi9GD6rguLX3ycaFR4XKF,20696,1363959,755108,529823,697444,3367030
5CVF6Zkgc1BWbEqE5SALT6jyuk9ku4HbgfVSYLE3BCbwpZhm,4261,358399,155445,148813,200262,867180
5HToi16BiSBB4zAFUNCLp5Qgu6VBQupCHZt4GMUowfouwHsM,4341,365118,158359,0,0,527818
5FscvV2vpBovVAqYfVPdfG78hFsRzViWfQKYXWVeWcX9qAf6,897,7468,32711,0,0,41076
5CDsSR2uxdb6h2DZwjMcrBoYtWGuQnhV3Lznoy33P2G9qus4,2476,83776,90312,0,0,176564
5CrLJcap8aTpHrnaSvLq83QDCpSNh5yWmvqW13yqGDbrMs8T,564,41766,20564,16333,21297,100524
5EngtmyvYCWWbWMFxCETrr5Pd79K1aEt2Psz43T8nu5Qmxdx,362,0,13197,0,0,13559
5GTbzKs1zDj5xNMaVyKSxNVWKaz6RqhJeoecDLVZTRpkbzEz,3617,153370,131966,68376,92171,449500
5FCaN8LmF8qimxjt2SQHX7NayGdvrNAv3hJW8Sj4TLxabEhB,1973,66769,0,0,0,68742
5FsWBpRfRPAQNxywKthwzxUGEJYUTthfC8fKieRzatt87krE,1151,16913,41993,6717,15513,82287
5EbpvJ3CbNX8fmJu9UQ8qvB2yomaHsLrs1qPTi7JMM1m8CGB,1890,179034,153640,231214,286315,852093
5FxgYvi4Q3aU3Xas63ksu7oMKhwokn1iesqzupnkim8Xnqrf,5097,428730,185949,366570,456948,1443294
5F47VVzDanPF9xeR7FSjCJBZDCZypkfCG7o6MsksxfL5Jn27,1158,17007,42226,6754,15599,82744
5HLB3kjkwcfVyyGtwFYytWksTigyvS4MpRJ1rH79LxBzztPL,1782,26181,65004,23827,30474,147268
5Eq96fJahT7dw6N7xond3h8PePrn2q9YeDj6JTyGoBnVZFDe,364,30579,13263,12697,17087,73990
5HCCpFmW1v3CcCrrSCGeyXTgmraiHZ23TEPS8RVh3zsB9YYR,754,63406,27501,26327,35429,153417
5CVMcRbigUhgcCsoNd4x1jArJ2feQB3DARMGtWWhMg1gEHnF,38018,2334195,1387082,853570,1110148,5723013
5H4F8iu8RzERhPnk8EBaJM8fuuo65tg1QaoKZKb1MXKYr94R,2174,73561,79300,29067,0,184102
5ECskJJsZLsS4FJwpNmUYcCXVDqfj1BUMQ5uvrnwwvjkRtMD,89338,5485204,3259552,2005833,2608774,13448701
5FEwn71Gyk4AKsRMoThttGPNVALwb763obDsJqX56dzM9RA9,29959,1420693,1093072,599201,751556,3894481
5CoUQNDcFBeuEn5xGyeMWnSLtgXgLNhdX96bCvRrjrHaeXDb,1585,133296,57813,55347,74481,322522
5F21J7mxgCRV3YHoPraAjdnyaQGoJMVDfcmxcJDxjF58Mzk9,117016,26186542,10274700,8416445,10491541,55486244
5Dr9DWxnc8ACiuigECETGC2GxGWgQX9XKyg9NiLW2Fyrxxoy,585,49209,21343,20433,27497,119067
5EnpJb4yF98PjfsNzJdGQUiy1tWBh4cASzkreXjTbe4x5f2w,2374,80346,86615,34068,0,203403
5CXAhA8MK5BcUwkcpAmHbSK3E3gv7RJShKE5tWHdBqMJ6KZo,4901,217373,178796,97130,121753,619953
5HSnjtTETEc4kTwLemxdLZKUoqcLt3zLKME9NaXMuNkTWPHT,644,9371,23490,0,0,33505
5EJSiPkhrBWCwLwUMF4yzUU6M7j6NRkHR9WXhpqV2qQAAKF7,16042,1349479,585296,560323,754043,3265183
5C5ChrEAcFBFP3vBdUcZBNLzBVVZqryJrrn26SxrXxTFJzv8,1446,121572,52729,50479,67931,294157
5DSKkWiQQY4gGGF1oWFPAPTgKkjpBPGmKJcKHG94i5sLs16k,9960,429067,363397,173875,221338,1197637
5CPL8kQ9QXoL83RQu618LNGHmcQ37EBqrAbCS1CaCNJdWKLD,384,0,14002,0,0,14386
5CtouFrn1n9Rsi8u1aeHXMevY7QV6HjhRapwi2o6xkri24Lv,3057,103446,644330,642374,556440,1949647
5DPN8trFjvctvbmUvUsHaWeTGFqa5eMwJ12hzXjsbNKTU3uB,373,0,0,0,0,373
5DFmCuS761qehDr979cd2pcWXJvHYxsLaoMbgr1UNn1H1GoQ,2456,158295,89580,62672,0,313003
5FjJM3ZPGagYWBy5bKe5rZhRRbMzfof2y744CZ1quAN2qXjj,1148,96534,41869,50507,67969,258027
5CyUvQVkV3i7KBuBrFwAwGVnV61wcR7CtGT2A5h4PW7x5bEA,489,25293,17836,9683,13073,66374
5CZeshr9fKZ8DN8o8fieLPqzB5svnKBnaZv7HfDpbsWRpeqK,1210,17777,44138,7060,20692,90877
5HDgoCjSQm1hPZeN7uZVX1VJ5txsiJbZVTLkWf1VK83rs23j,491,41239,17887,17123,23043,99783
5FvceyswbsFo74pvmFyhPueShdRWr8sD6rzTWCB4vHeFvYwj,5788,222927,211146,90720,116727,647308
5GpB7JswVWketPnikhELT8LhEqQvJsqVmWZUKbAEnhY8Noww,885,7371,32284,5164,6140,51844
5Fs4y4ZDrT3jjq1qSbi1bbb1hmWVFSKSpKuBKog4eZDFWAHc,18045,973722,658351,436092,579203,2665413
5FHxVe9RMbeCnSJcTjiqz9QUct4Ps6GW5ezjVjkxAGw1PPtc,3724,132412,135856,0,0,271992
5D4SransULSdrFC6y2WvRppUzBkvWRVFBBJ7Xw3TBw45rBxT,25279,1129530,922322,458441,582613,3118185
5FuesfxgwwQNEdom9s6Hd6eNDDT1zMgwost73c3UBvqRSq68,5610,471870,204660,195927,263665,1141732
5DLiPf3xq8257jZ5NNyrbtfPfswqR4K2TqANMnaBLcie5bdf,1880,100381,68585,33337,44245,248428
5FBpjHsBMvFkXikmc8ELsUAXxfCmWk6qqtdjtgnS2nVc8Hef,3406,286502,124262,118960,160088,693218
5Gsoxi449bxGNVaPXSPQRv2CK4JUs6NN1bzaT2HdapfMXiQc,1747,25662,63715,0,0,91124
5DRrFShJ5EzVqazCo3qJ8MxRwQJ2sqGoW4ooXuihnfuayV3a,8391,705857,306145,293082,394409,1707884
5FYraipePUvPNL3BsDJHYe8UDn2CR6NbG3gzwkdWNs5WpVYN,1689,24814,61609,0,0,88112
5FhT96f5siyrh21YQUXAofTetiwwuugm1osEcDYJz4wAZzjv,1405,41852,51249,0,0,94506
5HK5rDXAyPvTbtFaQfXCGi3sSWbNfcJyhL9FVaVMfG8xneGb,2360,79853,86083,38067,48722,255085
5Cm2Z1qmCPvAcHmqQqq1XuXRzL9SdaE8i5SqdoG9j7XepNmT,1587,133485,57895,55425,74587,322979
5DD4N4HvtagsTbj9dJvdTaWQQsn1XQ7QXrM8YTyweAxsGYBj,470,39464,39133,44406,54680,178153
5GU6btExgDvz9DtPXFhwPNPwpFzoJZ7XzHuzw6etuDGnShxv,1971,84452,71883,66862,88571,313739
5GZPjfwhDeE4EkeMSyAGQ5LSZnPRqhEvHhtoUqYb8GPeSPcD,738,6142,26900,4303,5116,43199
5GscyQow3h1FfyfexdYVmgP35Chq7APsosZMK8R3KMYFb4t8,379,0,13819,0,8180,22378
5CLtnLTFpq9ney4syFXf12yf2W7r6T8tBPyBhJZtsELm6UAw,425,0,15503,2568,4285,22781
5FLCVynGftwPQsnHbqCZka95z19DVf1ZEtAwFCtx82xvEyYA,8862,369487,323316,154698,196926,1053289
5E2M2uvVSV4xyrB9vc6b3ja6qJMmRvkZoTMj2tmKS2scr4vg,499,0,18184,0,7949,26632
5EnZFyTgRgLSNvMV4Tq8fthNnyYJkFceGqYd22JBmJMG8cpJ,1031,43098,37588,16352,22251,120320
5EyWCnfwoeEd61UzS5eCSkEMev7XXBmCTo1bTvsfomGNGSbA,6117,227393,223169,0,0,456679
5GyBhPmbYwg1dhkGukk3f3X2hjqKc7kRxMJg5sQJ9NsNV18Y,433,36360,15770,15098,20317,87978
5Gb5BjkaXiUjNS8r7Qe5zHwh4UsCh3c8DYQLPvhC6U1fqgGx,1162,120074,96172,124644,152668,494720
5HmjpADZMMGecBzEQaKimCksDRn3CgBF7HyhrgCNXN3ExtBm,779,65532,28423,27210,0,121944
5F7SWBiiQ1eDdXfxkQhRHVXJEPXSL99SyJCQHA56L431EE5e,928,33299,33848,14725,20038,102838
5Cz5dDKww8K3zkLH3D3FC5zZ81RGPPKt4dTgF92uab5Jve2i,1268,106621,46244,44271,59576,257980
5HB4z9KcEpvmEgB1FyGL577cAe7RtdU5GMqnpXZh6fv4bJYq,4419,181889,161216,81901,103718,533143
5FXExtyuiSbE2hEJLqmWBsghoGBMYrvDXcrtptNaAoUVoA8Z,5744,483197,209572,567946,702430,1968889
5FusQTeS9FYUZokwoAX5Z98CRjJgEF29VirARorkdhT2wHcy,3579,127258,130568,54668,0,316073
5D4qbUjWxLDCNW7DWoiHnQkmM5tpkgynpUmJLngPHUE1uGtj,862,38369,31446,16290,20280,107247
5H3bDQ3pnrWpbAn9g6zUEG4rhqs8ML863cbtyH5WBt1zXam9,1556,22854,56743,0,0,81153
5FsHKEZCFQS44K8TQBFmCMuYgN3zyf8Bvsy4idvEihdjhhwE,2039,69000,74383,27265,0,172687
5DUGWU1f5z3nWE5Viz2xTiN5REBpN6NutXhcemB5MwHrEErQ,941,53704,34312,18626,25147,132730
5CPBkri4aJxjPoDnkApNMsQSfLX7mbR18pYAocw6KDeLhwCc,1081,69695,39441,27594,37214,175025
5FBh6KF4eRc7qAMERxskq28bSTK7Wf372jBiysM32VaLbYdi,543,0,19795,0,0,20338
5DP4CvCQm9Q6MpCVcBxF5kYqD4EioK8oyK5oTF4FWuSW9AnR,1809,73584,65985,28705,41954,212037
5EFLDjYvN2343pLvQe58jp6Hi1aXUypU8uVRg11cMQdpxai1,2303,77944,84026,30799,42753,237825
5GZ18if3LMU5Gc5DoBADeeqdPR4SEvB4tgqwKDQzMKBquFZu,822,35217,29976,27882,36935,130832
5He6fQs8HR5KRA6rhynS5DQFhBWAuWGNcdfoSx1mYj3wJWLG,988,83103,86742,93511,115146,379490
5C54FcZ9NYN3yRnZb89Dx5UiWgJ6k8bAyWaP7etfiVSP1T6K,3616,304113,131900,126272,169928,735829
5Fxc2L6QZBpawTSiFzQnHbcc3xoMBWwvzH3VKtroYyRSP7oV,1452,122119,52966,50706,68236,295479
5DFeBJtwKKiAgQq4EFG1wkVpH9xf3xouovvhiWtL5EP51YYe,2516,85143,91786,36102,0,215547
5DFcm6nV9DTDm1JpxDLDa5ofbRdKTK91xsBaBmUW9fYCtkD1,6258,526361,228294,218553,294113,1273579
5D2q4YJqyV5yv28D2PgdLoWVDLng19sKTE3pkyjxgYcgoMk4,1971,66685,71629,29756,40541,210582
5FCFsiQeuabmGVayzxX35f1H9nFQLxHNLk2Rr16NqHWJU9Jy,827,69504,30145,28859,38837,168172
5Gwy1WuDQzWHCKV4MHGDwbB6R2foowu8XxexfUNkvXA4tdvh,385,32344,33760,23757,28858,119104
5HnR5UjZvaVuCuzeXvdB6CjRytHQwqnjQadudLMo8LswoBqP,640,53816,23341,22346,30071,130214
5E1n4gd5442MNCg6TZcNFf82jPW2s489U3ZXjNXHpAGmH3yK,431,36184,15694,15024,20219,87552
5HL2xAAeHigvB4s4yk1MwbjDQ75mC9FB34xpRUaPH5JJUWqh,2642,160051,96362,62576,83111,404742
5H6c3wxTM8ojUPFJfKsNNJWb44Lc4Bt9qRKNNvkHZZegWNUb,1137,48718,41468,38571,51095,180989
5ED3ab5Lf1EeXrCsJsYcFCGe6xNX6Kumsmr6mWVSqxdZFwGi,449,0,16360,959,3112,20880
5CA51CGS5n2kMQYiNuapTHswFW9GCNjDnX5hoLrFFxocxZ5p,107911,5786939,3234371,2142802,2800740,14072763
5H8wxnpRXmNCUUvVsL3AL5oxM3zBuRFrT7kceJvSYxRUFXaN,14427,561497,328713,324141,365347,1594125
5Gx79PYfUjnp4aH9ju8dEA7TGvyG2ABAkEwugrcM9k7T1ep7,10067,394753,229361,230543,258913,1123637
5EefBfoQywjGMq9Hn6Vg8nNN31wa9EEfVcq91XCeEyWGLLCe,18688,761510,425797,0,0,1205995
5HMhcuqELTsdbhUszV3NYhngtrcVgnhyziJuqFUThz49MF4V,11328,440881,258102,251309,283189,1244809
5GHeFmFJ5BJ9ikHbEWxrgVmd6o7rRGTo9oQUKheomw9tQGUN,3980,156058,90674,91141,102357,444210
5D4Rj3PZubLyYnshzaXsFiSECoxXbFpMGrMivKL4miFfzYeG,3115,130059,83137,65051,83604,364966
5DheMKBoREPEXGPm29b64chEYUKkL3Zac37cq24p5zQcG95N,18523,699126,422033,386122,380285,1906089
5FjUZTs8Z898hbABxn2w6mnXKGACrkEBwaCjizhBVGgdERWT,16110,626981,367049,361944,407955,1780039
5EbgpTCLTwaZ1QqxFSnE3oLUiL8kKyeBnsyDFMt9fV4LVshd,22728,895517,517841,342729,448470,2227285
5EkZHedKLbEbqSrWF4fXEGCii9XNRLxhEnYMsSqR4vPvNmvr,20483,920306,466690,330374,419341,2157194
5EFBCnbbFh9J4uGrB11zKpdFXwzSAFfu4eKWpRd3rWYj2KNV,23000,895169,524052,516764,582456,2541441
5GbrU7yCszAoVtz8DPtiZaFX8KgH3kk43xRpPQa3wXHAi5aD,5287,206691,120463,77958,101894,512293
5DkR3fG8H3Ag853vdbZBWkfwMUHpswf3KniZqsUhCvvnsQEk,15699,615628,357695,363978,408879,1761879
5Ctsw5LohxhRVRrr4u6ubNWhA9VekfGiR31DG9haUR2kxbiD,4331,168565,98682,96084,108274,475936
5CcsJUGK2RcjGcjftTwJaPFhN5u7rct8DLvMFWwsRUCK4UrZ,33866,1203556,771632,619723,892064,3520841
5D84YVE9yHAH8rD85YncBDJBKtKBnLd3xSZXyUAfvhuwrtUG,6684,292523,152290,96187,119204,666888
5HbV2n1YjbVChCatQKwY6NgDo1h89H1xk1TMahjY7qWKHytJ,4189,163403,95425,79041,92762,434820
5CcZ5zn662WKezZxAMmD7yRcB3i7AJiWfGnD88LXxsy7UCUn,14942,488471,339010,257606,296454,1396483
5GeEFepDVNbbHkHvANCpZcmC2cMiKKrZWQA1WUCsBSk3QstT,3319,108479,75605,57451,65162,310016
5FnMySHU5FE8HbPx6uuVKmzJPvnAVF61Bei41RK74dYU44Y2,407561,18228150,9705083,9397913,12231872,49970579
5DRq9YF1izK4a64yYSJocNCWrBPP1TCkRrmdY1beCkrRyKUL,124699,5304542,3090126,2328354,2540442,13388163
5GNB3yCw4noa9KWN15KboHDHiKkgzrJL8pkNuKN6wH6H3JHf,40476,1269550,773238,587115,857111,3527490
5CmCtE9SaJcei254FpBoQxguoAHFC4J9sL7ocg7joK9W81aa,19658,671105,390993,326828,406492,1815076
5FNUqAHHKmqdttyJ6RmRjKS71n7CnTTnnHfv1BDHTaXNn5Yu,10537,343027,199901,180240,231066,964771
5Ehfjq4asKkMM52N5ZS1GxzLVrhRRzkx4BmwtVDg5e2RpPWi,14167,467113,254835,230648,300945,1267708
5Cw4WrnAVy7U185dnwMwxMYeRbiiZz3kLyovZhZoB7ULyPJL,55877,1884388,1005140,906248,1335115,5186768
5Evb1UcNY9ECKtU1EFcyDyqnwKmuPfdPywWxoXYo5rodwH6M,49432,1737721,876436,748659,1120721,4532969
5EUzL5Ncx1V9XuZJmZxviTswbgXeiJHdzjTwUndXCHpeN2aG,39311,1368308,745827,771564,960444,3885454
5F1M8vnm1YMo4nEwnFzfoZbUKaNathFVMLaPrRNAWWthtnQx,9715,337650,208464,0,0,555829
5Dd1cjQVHH2JCVHKnHe4WMxzQGdgQBdVhDk8voyqUreBhM9P,121886,3988944,2195131,2005450,2686556,10997967
5DcnTH6ueaDUvvaqUK9Lym2URncUhduNDzzSZKskZgXTRNxG,16150,535295,306403,0,0,857848
5D8Khcr58kLceAhZWESxvT1CefszkFrHjHNiwz1U7Cbf7Y1D,10207,349898,194978,184907,253863,993853
5Hh3ggCVQrS3ZFv87nKxYEAAEBEQ5j4118SnM73iDaJBxLfR,7863,241922,150202,112847,152175,665009
5H3Qm4b9BxzwjLDoD976XxgZKNvUGt3GNobPEz2aAtroXtWi,45101,1481134,811299,722864,915521,3975919
5GEtjpujbteyQN7bcgSu4hc2A4jD9HrpZ9kvutXfMwy3RNNv,162011,4973429,3170100,2045573,2638712,12989825
5H6DAN4oHF51w7ysmqaSx4uZqF8j5d4KBSiyc4WNueAvsG5W,46216,1325933,728099,691432,904171,3695851
5H6nWz3EHXetnNPYZ48e2pEsZG4Q3vMp9CLAt9PHiCtDP3yr,7136,164997,0,0,0,172133
5E72Q88RkukhknQzXWx9QGFFN5FF6gJCWnpVyup4n9vBWukS,61929,1270428,1036138,839874,1011575,4219944
5DccbbpsLZLTgkiUfUAiRLqtr7hUtc62vcdwkpQxTpdsB1mj,462157,7183938,7732371,5293338,6601909,27273713
5CqhKtKNsVmHiVNF8KUnLLsz1vxVc684iSEsgN6Dbq63Hxwb,33642,899811,562853,390471,579505,2466282
5DD3mySQn4TLS87WNYfEepsNMkKfKc9GNC3DxBF8hG4Nqxzv,70361,2205607,1392202,0,0,3668170
5DyXdmV2HcD6DAyzf88pHS5zWxx3zJEmU9GzFSUxfTGYksaC,10630,245264,163215,125691,161421,706221
5CaU5NKZ35USKPaAg4b9isxK6df24LbwyyjodFCZwjszWa8c,14790,426765,264342,261099,319910,1286906
5FqYb4ByLDMGAiHXJkNFehhVKLSbKMkLDrATtWTqgUsKCLg2,9244,309302,173720,0,0,492266
5EAUdirtPpmzy1eopgQBTtcP5QstmcuVcQUzHKoTDBhRRp7Z,185044,4428080,3366964,2136203,2455965,12572256
5F7dU2Tv4zXst53dfQSWjfum7CXLBD9gq5SJGE73ZVXLhGv9,1849,89536,48100,38531,50851,228867
5ECZVbmwnu9Lap6cr9XKvM12EV87pCVZua1zEUPr8hY73WnT,1132,9876,29432,5179,11947,57566
5EZEP798orJkUMmG88cxSy4PrzgzAbyLqUFmG8NbM2hZzKLj,943,8230,24526,4316,5719,43734
5FyBomoRYx2DYWaVkrVSGXkNpfEhVKF5GFm1h8GWgP3PeqW4,3447,1476774,703364,684647,845844,3714076
5FWA1WVzgT7mmgHJnjurCUWJy3PgyYKQv1P4AMHssuuMQXFU,755,9899,19621,8556,11051,49882
5HnN5xmXCC2PQ5V4PoiSPfs3BEE9jwzi5Yq1SvCBX7wU4uYP,1886,91309,49052,39294,51858,233399
5EZBcU6MEL7ordnNPBTzgc5PCFgEiZoSnyc6C6f68z8ePmDu,855,7459,22229,0,0,30543
5D4dyMZS2vW54EpeJApidV3f9SoajD93yK44GoFeGwGTGGCV,378,0,9811,0,2288,12477
5CHy3Y51iHVwiCtBrHuH5KCgE1wzou6Y7A48qv1vW33HdouB,378,0,9811,0,2288,12477
5Ebgopi9hT1YQ1yvYtJGnkaj8MLkSfG9s9XdwkHeqWzoicGn,4969,120960,129286,51699,0,306914
5GsRCXBq8ozyzYU5JZNpbs7gadoK63HdnQVQJXPriymCwZZK,2922,87108,76021,33149,53928,253128
5DoJDwSrKp3go5xsAQQaT6bKekfXoMjwYqRKbpA2iM5n9hgD,461,0,11987,2109,0,14557
5FjZbCUSZrn1hSAYDq8nsEpNaAxYPJvugqRAr8A9ydsbm57h,878,22984,22831,8986,11861,67540
5ENrEAamqFFrbxZZ3JqnWfxFr4RUnUw37iV3CDVN75sLtWnK,1886,37279,49052,21618,28200,138035
5DPnX42pdVVo4JH3KKtznHA5LH4sZa9jZsgNH3kkfHWENGZp,34709,1681166,903139,723471,954802,4297287
5DkuAkpzqaetWXzNy1CohNS7ePPFoqqwGpNA1j1W7ecY5KvT,1943,38421,50555,17990,24038,132947
5ESLZWERhKv1MsYTZBCWg1H5nLkW4WsirxcdfTXeMB5aTSyT,933,45187,24275,19446,25664,115505
5EtLCqV3LbiEib9Em8q4ceL94mLtwG1stLMcyuCJZ6GEZ3KF,53062,2232095,1321783,958549,0,4565489
5EFkdeSdus5sR9gkzf3y6R4xh6Ty1rHy6XdM5Q4fMzhQLKkJ,905,7901,22541,4143,5490,40980
5C9zdMX8Tofsy1qLognUYuD2DaxhKxyGVH9gpKvFctiyGD2t,1132,9876,29432,5179,14873,60492
5GWHv64uLZX8jbkDPs8cXWdGFvaH23jxzPZ8PgCLyhnuuo8p,472,0,12281,2161,2864,17778
5HbZR83ABNkmRaPzPCwLPcJ8Pc81TxaqhuxkPLzhUvoZA7dZ,3205,70917,83389,36750,47940,242201
5E5BwnYe7XCZGdHm4ZBAqUPUhpxCVeowsYMkieWLGbsa6M4b,1512,84836,39177,35781,43535,204841
5Df2NmBQLsZMQHGa81hAabhqn41bEMBBojqhAh8w6VnFdtk1,2126,42036,55311,19683,29103,148259
5C7tTSUiP8HP5f4kSVUhH8BB17rKWWx5zE3b8qEoUy4akoQm,755,0,19621,3453,4575,28404
5D1qomycWA13goKQFkHru9QHp4ewCHPdbExx6Su8cJzpWWgk,14227,461540,370189,198389,255097,1299442
5Ebae74W31hGf9Gpg4iK1P43g7EEdJHguWq1nnip6PkHz5JN,378,0,9811,0,2288,12477
5EkH2sGgib5jSu1sMibt91ghmyP29HX8cvK2ZJhhT61YGBFK,438,0,11381,2003,2654,16476
5GE9xXWYM7gpQVNDQJLYHSUVK8ifzZMwJiT6BQo5W6WqpWBK,98217,2925397,2299923,1337805,1723442,8384784
5GhQPuKrF5ezxiY3jU4xKsa3iwJN55CvJpGibtKHNP5TZKSQ,74272,168776,76795,91732,101323,512898
5GEAzsoJASLZT6Vy25B6Re76QFTcmDDsf9su9bqxaq8A5WLm,56744,3223551,0,0,0,3280295
5GTgEt6B1Xqd4qvq1HCtTGPP8wm9BcxtnjWFyZkD5oxF4ADN,29709,1396956,767928,743056,903559,3841208
5FvijhAerufpwNaeQfgi6Ek69BvsHm1CFbH5Gt8NLLVSbZKq,15168,664381,392070,345960,0,1417579
5G6evxCka9hC8atybSLdhf8oH1sLkerCvujaBNG398x2UWT2,2971,116791,76793,63495,76437,336487
5Gy6BHCs7MYJ15k4PvpeY2HPVEybZa7a95dsV4rQbAJ4a15z,4160,210211,107510,104895,114891,541667
5HK2rrsvFwsz6D6gSWhbx2H8nUtwvVdbkJXosJzPMV9m3UVH,3619,183814,90308,0,0,277741
5FveUZmSc6Bcidu9DCUYwS3borm92AegD7SqxRHpcjMKqY59,104805,5255176,2727808,0,0,8087789
5Dyb1qZaHyjhUZeF3WKN8hsJso72DJGPbMXC7p6oc8zKVRsf,30125,1573298,775413,860425,925343,4164604
5GCeNtG5SQHQjpLMPZSZK3MPnG35EE4kAjFbcUjemSTY1rzn,15506,662972,380017,333333,455145,1846973
5Coc3gN8AwVit65isBVWp8v88Cr7czPVVzFjgmUjBbXN8qwZ,15449,708576,390261,318211,409252,1841749
5FQw7BJFM8e6G8DM6EKSBg2V96iGE5c6dAFrv2XWjEmMR94j,12883,592542,282366,0,0,887791
5FNgC67NDFrumZo39XZta3j2W1VFWLZRUrzTJK2sJMrV37BE,10093,468934,260873,248658,249197,1237755
5GjDYsvScV6Bo4gwxibrxc6Xjnqkosv8V5pixz9sqJ4FLhAt,118922,5155183,3343018,2221897,2445522,13284542
5HdL3PdcE5EMa3sprvcrTfEwhgHLc6nEKub9H2hGtJZVhkST,1483,596388,305891,260192,361073,1525027
5D87RZjpfD4qpdD5vMkEMQZac2XW3hFpiWiZKGQ1AX95UisM,731,0,12751,0,0,13482
5HVmAUCmqoCszEMHKEgNWTu6YPxUUXxGPSApSuHW1hpvDrRF,36328,884224,686766,346733,435645,2389696
5EeSmbLmttnf1ZK3tktb2oWefoMM2PmKiymi1DQo7q4CF2bx,377,0,0,0,0,377
5GsM7hGeM2wN9kZ3K8QUuGZvpDfDutQDdtHQofQWWvC7HiN6,1648,13713,31140,6283,8388,61172
5ENY3y7Z4NhYztc5nvkH9qQx9uJmdxMtiLjYirY8Czh4Jfb3,2808,62056,53074,15535,20090,153563
5FKfeeqD2hGUSdzQXDv3sMMWRNAFuhmucJ4usRF3CsuhxoE5,1345,11190,25411,2633,6845,47424
5CZzFSUmEiMieTuKKh5ibHmBZXAGUSDR1BMoKwLv4FTVfb34,364,9725,6339,3868,4557,24853
5EWVmZTNt2Fc59bUVuRqFGRyJ698qYhye4VCvkjLkq99sDNU,582,0,10143,0,2824,13549
5FKmMxt4yK5Domk5ckp4FBxteXSr4m8Y27S5RCsRdiy1mcSL,3633,41067,68677,22105,27751,163233
5Gk7YbxaRtDvHAsy4vPnV8bYBzme5BtgJe6mXiY9Htb9Ffg9,695,0,13124,0,0,13819
5Gv6PCDhoM7JhvLx7bWRtmc7qgVhtKYxG4KZ684XX6u8e8qt,427,0,7448,0,0,7875
5ERNvPwdoUkHK3mxJFnawPqmWcm7JWYTX48v29aBJW74FLYS,5445,136790,102927,51842,61963,358967
5CveumrwR4ArQKRHTmXcTxvJiGjqmgjudbGx95rTgwwTHb8A,14532,353690,274707,138694,174258,955881
5G3xPAgdw88E7SCfuhJNsNhiinrAiZfjL57FyccqW6qkT4jn,819,0,14283,0,0,15102
5HHZc3sKPmBHsRzhhWoYoQydYtFYHZzBNXY5f2AY5zxyUhVA,809,0,14103,0,0,14912
5FhPx2u1XZunG1V58kJXdPkN9EqFi16ViLpqJvNoGv4EGqHt,1322,35372,6339,3868,0,46901
5Gc43vCy7FQcu2enZcUAAKCKDM1qVzhLyFhgg8cedqhj75Qf,494,0,8608,0,0,9102
5F1NX69cBnWLZbRDcAmvuoqeZZx43JPDtqKnsy9CWC6qKA6s,1255,33571,21883,13350,15731,85790
5FTwjWWC7SGSJwWPxGp86XuqA8kanR49twXWrdBrWLq68gNU,1817,15122,0,0,0,16939
5Dq8yvQ5QB7PDSpa6MRi5fkn647atZmxLaGhMTQisTz9itno,9662,208266,168590,92219,115866,594603
5CMYBbyBVHXf7wGgTm4DRwMmD6aAFyTf8ZRrXp3vBaLuKdru,2289,25872,0,0,0,28161
5EshTVqiTBCbnHoyBxKn1pzYqN3oQW7NvVCVV51TmVjeNPRA,560,0,9767,0,0,10327
5DRXbJSCcvHvjN4EB5UsBDG71YK6Kwk5ZA5feac6vNfYnLxN,597,15958,10402,6346,7477,40780
5HDeo1DKUuvjyhZ2RzMu143K6JRJW7vFtongz8J8rBu37inm,3648,71868,714487,364986,471010,1625999
5DM3tVKSxcQDGrjSewsaj8kbhD7dx7V1Ebo7sDVx8HuyyPyi,1817,8061,31696,4247,4888,50709
5EPA6VnDbmfFjmCfxQ394sUumLzywbZu66GmEcCVruxWnkLn,582,0,10143,0,0,10725
5GjwHCe4KS3yEiTkbu6wAJyAjitm1SbNiJVSfhTNuoRNYTNn,2263,25573,39473,0,0,67309
5EUB6fUSraB8EQjebCaD9fbNbLiSdaFA68CS159B1ZXTxdFz,1178,9807,22269,2308,3471,39033
5GsJsbJVzuYBMjBFZMr8RivJ5SbLcQ5BY8xKrRGWEw76JVkB,763,0,14423,0,0,15186
5HWGT4x7cz8HhfnPzefawRmEtVvMefXHFYYV8qMHAQaE63Dx,800,21395,13946,8508,10025,54674
5FCWq8DZ2ob5ppUo3PwEDDzxBY88sXZd7PRfBkS38knsHaM4,4672,61364,88323,38244,48253,240856
5FGze2BB1ajcYqc18xjnxQrUFm8K3kmj82qRYMAex5U4c3ie,837,0,14130,0,0,14967
5GxiEauBWfjdUH8aKNya8kevbH6Pb5etnAmy93engegsPpSH,1226,40300,21388,10978,12842,86734
5EZtNC5NkW3G7uVhwgA8ceYQnvMPMqpdLdvg7go1YXT1YdwT,2216,59322,38667,23590,27796,151591
5DU13kBBtuwe9BekmrzBvdNnUeC2YrebEVsot4UrSj1Tnyiu,19952,485631,337193,190432,239264,1272472
5DnaqfohagHChEEnCsMpXGntK6H9eb9QaMWAtUWCLPAUubSd,577,0,10901,0,0,11478
5CkLDa3gzkkCuqx8sh4yxgTw5i6rBdzWRy4aidkRHCX5WuVj,574,0,10836,0,0,11410
5HiyyAx6KeqkNhEr4K2Qz2bsvAFWVRR5AjPqepiyxe7Ptqme,1859,49748,32427,19783,23311,127128
5GmscsoEeg1ReqDDdJ5kvmXfGbCXgerLA8zq3Fi8WsEedrhb,1364,169664,112458,102834,0,386320
5D2fLioAPyvph7d5TrbYP1LyXsZ8JBoy1HEygAKG97XKLUAy,909,0,15848,0,0,16757
5Eh35tbwCH6FBjy7GxbTViSRXsDGkPHugBzpX6wWMWzbttme,7786,167827,135855,63733,93368,468569
5GuYgx3Uf3nYLdFVF68yX3n5USVKbqGX4PJ13VtVJd2wwsjV,1345,11190,25411,2633,0,40579
5Dy6X3kzqP6mb94NEUwjcs8AvnHbR4D8P5GuSiJFAAAZZXM2,3490,39450,65973,21235,26659,156807
5DywvysKX8EDzXdxBVD72miVQPF32UhcCW9brvq1JAs2oxFd,576,0,10889,0,0,11465
5GnL1FTvrUGDFLJeL8h6k2X6ggEqBa2nsN2oDa1Mxb8ya9Xg,377,0,7120,0,0,7497
5EbfCnVJB1zA96G7W8vrESKaQ3e4QLNoUaHF6Kshotwe7atH,506,0,9558,0,0,10064
5DWsppg44HJixf9vjeJ3miF2hF35zGKWu58QrizcXtoUz63w,1443,12007,27265,5501,7344,53560
5CyJWNrFRvZGm3LceHVZY7sWAd6T4u1shg5FifgYR5Wcb8Wg,4742,0,0,0,0,4742
5DMLtxT91HLJqwnJjgegkPdedtLarAGJMdBPsE6C5SEpud4X,603,0,0,0,0,603
5HR4kGkVrS9onZpGq2Na2KD6Jq8z7rXL3PamLh1RJvLeGPF9,3820,102236,66640,40655,47905,261256
5E2mv3Nr1oJayJtCaF55D7hEf2P1b1pKjS8DBoWqyLMRTtpN,727,19450,12678,7735,9114,49704
5EXXjob1zeRkcDbCwKGJS7a3Hftjqqb6BB8PRqKoaMZ3L6gA,4641,60956,80980,37990,47932,232499
5G25jpT7SZTi9Erc8DPYe2YjKMjAXVnJhUfGdiK61K7eFyU2,5560,119846,97015,45512,57424,325357
5DfTed488JjGqWLnvQ2fniZsMtGBVfoWuyC6zNG9xrm4wz5x,1184,22058,20649,7962,14590,66443
5Hmo5Rxrxqka9icHUucWFGXJRat9HQcDCo7ndHVwwCBizFJV,375,0,6534,0,0,6909
5HE3ZFueZaEtpFv97aGAzesTBEctGcQBo57eqPVsjpMT4Jxi,5823,125518,101606,47666,60141,340754
5HELhwa4RhQKgxSMtUwBUx6UVGJhTSskrEnRQ1FhWYSM13k2,2291,0,0,0,0,2291
5F6xBxQYVCdZ5HL85nN2YLrZjkT5qAZEuujeVcXyorf5tHTZ,1841,48413,32121,18889,24327,125591
5DecXmd6nB1t2kGGoecyikBsPR9g6agKP3wZ4v6yXfLfqsNj,1908,51054,33278,20302,23922,130464
5HTbkJUUMXXV8eC9kGQDujT4Sc5ggJaPtBQDdjxZYaSbBnFY,5679,122407,99088,46485,58651,332310
5D7BwqchZRSdok3WiBk6JEo4Pp7KyktwuA68TKJjJ1u16RxA,580,0,10115,0,0,10695
5Eq3skdkYKAEYZBAvzoyPGuAunFMBKgcErdyfjGG977df9pZ,697,0,12162,0,0,12859
5FHwehhj4hMwRGPDVrH9xmBruKAZZKxchRLby34qtSW4RMgi,411,0,7169,0,0,7580
5FFXi42VihNMnEWkpxVskEJjJkiBkKcc4iQmqWNnFEHWXWxt,8356,180105,145794,68396,100199,502850
5FxWt5s7R5KNSjN5JadriUThxLkUfstABYH2UFap7ihaSPf9,631,0,11007,0,0,11638
5Ec2pTPo1kGuq9nmHtb1jwjFuF2xDu13Z4hE8a3oYAomsXHT,2939,78651,51267,31276,36854,200987
5G67w1XgmmJzjxGUKWHaw22nNYygotNVp6z8QpNuj5zkZ6jT,580,0,10078,0,0,10658
5EbaNgPM5mRtcfC24wdERcgY8hHQvubtSXbXLh9NXSMBgJMp,12998,281586,226795,113796,131821,766996
5CSUgr1GN9gACFxyb3kVmEuvo24jrXKMVQhgKuvRQkMdDrRC,1505,12527,25430,5739,7662,52863
5DZRXXj9xCTWqGBGCVwjuPRkH5d9zpf46nz8F7GBQvW6VzBw,1070,16436,18669,5728,6761,48664
5GTfjCcqiP3Wo3p3pGGyHRoz4GVvLeQJf2Y41hg2VxsioYPg,793,21215,13829,8437,9941,54215
5CLSp7vq5235mNHWtF2DxzxLb9Fyz9asT25diVEgwBQAGYGR,1186,0,0,0,0,1186
5GNV8hCcVXzsUxuAqLE98FxjV5vb8G56FdMc8KewaeKhbgYq,574,0,8851,0,0,9425
5FpNQ5NfhhRMyE1BMCy7fwPXHtd8ht6mME64AFr58y2ehesc,291153,8993812,6048567,3617417,4189380,23140329
5E55iJFtDktQKboDu2MyrqDkjW7tQHmv76DTVAmbEgkC6gij,3458,120692,58014,60467,72872,315503
5EyWDhnoFgyptK56KCzLooMYVgcUkE9PCjWbiGjjW9dFZiAy,6467,200081,108054,99989,129239,543830
5FsxUwuRtVLFso4zKrUAEKaY1L1K84G6E1UCT51YKD6QYez9,82469,0,0,0,0,82469
5GnPBa3xAEsM7udGyJiGxEK3xf2LZz5oGU49xAZt5yjcXKsq,42600,0,0,0,0,42600
5ECXuELsrsLzAF4u6G8NxBdPWdqaHh17uCodrfUpx3DcixNi,3846,0,0,0,0,3846
5GRkLZCT8e8u9MyxKL5r78ykgUhXYXe7RZnX7T26ZSgaieSg,17286,540998,288849,292045,354381,1493559
5H9D2Vt7NWJCVVR1G46H2B2ZfNuCQA5sgfzY7W1fJ9paVD8c,1803,62916,30242,31521,37987,164469
5HdJEYbSZhrNBm1AMypnR39n3Y445tzNM8CL4QRPasiPRv6H,418488,12113724,7022782,6443530,7814812,33813336
5GursqmYeVtSnacEKNKrhNfZVPrbmkdcKZSi9oRhogD2L2Ug,8643,176191,144425,100803,128597,558659
5CXNSeqXp6Hnhevc7qK9qqHdNcWzM38gYfEg8iHpZHHZu4iD,151550,0,0,77119,0,228669
5D9jM84kF3m99xLhqr2RecwaYtitrjc1ngpupf7aDer8pW8p,43114,1173100,723506,585809,700639,3226168
5FqbWdMyyXu9LWgBSfhTWqZnjKWyBeaQNNASnPVxe4JXc7Yn,8947,173015,150132,180063,222515,734672
5HYrEo225w4dbyAtLE4w6bRYRdGsrgqp8tDBRPPhyMC4DLZ6,2615,56040,43693,37303,46748,186399
5GYcCTxHHDFUQjH83eDKM3i8uhZTA7aXVhjmGMsKmdevt9qm,4026,114234,67268,62892,78611,327031
5CSvQb5j2QsU8NzNSB1eT2VuDCkGdYUiYcgYfZpNqEdJcGPi,32842,1146573,551127,574437,692276,2997255
5CDqaEE4q311KkspLwe5XD3J2bpoQKEDdzhe6agn8NCroib1,20075,700848,336879,351127,423157,1832086
5E6nWjog2QGh3XzyuJztanySxBqFEmyz8xfUG1VGZEWdLgeE,18791,656021,315332,328669,396092,1714905
5E1vYB1Ct9LFvYgGvN4x5MFucAQx5aiFHmDbeWtJUfLj5Rn4,1729,111051,53362,0,0,166142
5FL6ZoDvvswwG39sC2Pygbdng9XLmjALZDRcwAgKvZHuwB15,17340,365723,289753,0,0,672816
5EWg84nKiKGRRqsaKg9sgsEcpBKHDM98qj16YrLPVXRHDZQw,18066,437540,0,0,0,455606
5HYtEDfDMYQVpLMLzKjB2FtuhEQ189NXFoU2HAZA5gWCmFLw,1902,66381,31908,33257,40080,173528
5CfPkCkwUQdRKZq5U5J5GMNXxUmCWdJCstKUNrQQBKJ5yicv,8612,0,0,0,0,8612
5CUehEVz9d17JAcgGYkUVzwCsqjNZ2o5QNVTtzsugw9mnS5j,168128,5096095,3115607,2127194,2539148,13046172
5Ceqvj8Fhw8fVDDiDfLVDTG9gTmqh3A7SVDnSGHZRnfi4KoB,1551,41066,30121,21183,27984,121905
5F1qAYEBzuXpPD1ZZuLcQ7hMnpJfsuwJukBY5XwXvnCRjepA,1478,38218,29797,25440,31881,126814
5FQwf6wbBoK518QN1wN68E9r8auBHKLPFqHaummK5gK1JdVk,18809,334866,367013,998982,1248930,2968600
5GNfhY69ptGxZtkZNf3nWkiLvChfQHrJNvXWuk2cARhzgkFg,53369,0,0,64348,0,117717
5DswwgEV91yPYfHvr63BwrkwSTteojPcmyrPn6xhAx8ZoK4r,3245,0,0,0,0,3245
5DhMSKddz3Xp7taEFHbe1HdTXvguxsjnT58pVCjNRfnsYtzT,1562,25420,10195,10196,12977,60350
5EPgC9Zn2H142RnRvGD2Vk2eXwGxut21KrLfJyYea2voQaQg,25136,0,1598095,1419275,1729049,4771555
5ECDtd69M1Qj9zmH9Gg4XCi8Jm5Bw6hecefhqcaojurdquH6,4278,0,0,0,0,4278
5FR1w93fczggRP5oaUzKRBGgaid47sSAjr59jWNXkiquDY4s,2573,45795,50191,30282,38088,166929
5FCW1fu9QANRzPG3Dgec5zS2Hqxvq7k6dRLYLWJrtkV8fK5N,2594,68708,50395,35441,46820,203958
5EhYZsEwsMfxdN1jZWh8W3AzESYz1Ev7tXk9P7opNDtv1caf,14753,425681,287862,280811,346992,1356099
5E76MWcTjTR2X1WfxXc7p6PbJH3J71zQCPJFcnaJo3nAzi4C,1888,23829,25708,11835,15194,78454
5CX6Vg4TJJsWHTkF86Nc8gfAGQgbiMpqHqbTQLCafqrxXED2,1433,0,0,0,0,1433
5Fbg5KFTxUWjdN89X8DctN2S7EdnB3sbAsQEJWsk4Zg1GNi4,2001,34404,39037,7068,9535,92045
5DLxwFCULa6Q4qACudz4xDjLLF2oxCRJe4hmWzd6WSKbuL49,5105,35614,0,0,0,40719
5GUHDNeb5NDTy7PA9utQJmkCPftwhEwsVd19ZgFBq1V4ZiJU,1555,54951,31488,30326,0,118320
5Gc2978YbRcQaVhHyHb9bDcCYWDp8kgNKw5ND4w1wpwqgeL3,1433,41329,27948,27264,33689,131663
5GpXjgZJbY4WmP6KnTCgWSpuzHC7zUqyamXh5vqa7v71XSD7,71612,7787462,3847288,3820874,4991837,20519073
5GErUo4A19wTcnD6BNxVDn9AcqdWzFBwL843DSydggMEDYHq,17368,355629,0,0,0,372997
5Cvqy9UmJdVRNsLD8KuRf7Rsxwg7Ak7rqp5JojGz7eaygDRQ,6663,143433,0,0,0,150096
5FTy1jvJQtMPukzkRaaJiJRPe4Gs5GML8SUMhb6JVHhf9GaF,2937,100907,59214,52084,67308,282450
5CRt8dCcaX2aWUqSZMuxmVe1MM8hebAV3CfhQ2HV8ivuhgw1,5013,0,0,0,0,5013
5D2oSmenxAPVRGKwKBpnRTBqpcgjiMfCVzPj9AZdPjTt41pE,1433,0,0,0,0,1433
5H6phdKhGLTZ88bNaqkPHKsgJJMK9N3T1MLd7FNxs3hqLtLf,1945,0,9285,0,0,11230
5DA2ARuP6phpzmGaMZKwZMmxCTatPdAXTFrje7qksquKdN25,2576,87936,52161,47034,57067,246774
5ECcPUk6cwUmAiWrqD7mX4uLBxQz22UoteBp9SZT3FdMubnZ,3370,0,0,0,0,3370
5GKrj7hGSTPzpJD6YFmMVoJZPcUB4U786C53sHYaMR2MMA2v,1627,57492,31607,31595,39457,161778
5EqBu1TYuYRR5RLYdLWHMBPhGo4B4csCXMFxVAWaskipMJCZ,2418,0,0,0,0,2418
5HDqGVaPiBL9KfmK9kmkdVoVXE4R6VLK2ULsQwRx2SGB3aRR,1719,51808,38380,24329,34066,150302
5ConbLiQRw3DQCM4myDDJS1YFA3Lw59FBfEiR6S7nEtFge8T,1447,23554,9446,9448,12024,55919
5HDrDxJLphseXe4rfCsf1jkyp5hTuBqPaTf5QyKJ7LLJhL79,5435,0,0,0,0,5435
5CcivyVu9U5NEF7NWVy2MTjFpwu8EcU1G3aeiscmYpdWnLE8,1433,0,0,0,0,1433
5FPGzWtwZ2KhdUh1xGYzCF8uQXnZDbKKDbzpcCErZp2Zt4eG,136989,0,0,0,0,136989
5Gy9zmp4gwfR2NHrtt19P9xjA7Pcsak5hquqGFTHkdX3ypwh,16586,0,0,0,0,16586
5Cm393U4vyDXEUx2YtnjfdiBLTN7witCF2kF7AjcSp9Mupi1,3612,0,0,0,0,3612
5GzuNbyWeCBUGgM4BxLxYcuMqivnTT6hfyE6RjaYLvTxWAkD,14302,587162,399740,0,0,1001204
5HK4eNmtBZAEt7hbfoGGKCK8zVaWv8d5xe8DdT5DFSp2xL7z,2957,0,0,0,0,2957
5CyJf1E1Lvj2EUaFRJc6kJc73rgWdTwVScvrRWQhwuJW4zGf,38306,1445328,1456950,860718,1267665,5068967
5Chn8jdNFcTXdoDjvZdvQqJ4K4y38vbM2Fcckwk8LZ1bYb8a,9546,679014,266810,341616,450622,1747608
5EZDSSzRHUkuqBHA4xw628NA7nJfR7Nd1Bn4MTsWtqtdqMKk,7843,0,0,0,0,7843
5Gy9pvT5xH9zMG3kkhhUSjpXo2pb8c9jPK7MvmjYycaNrpaZ,1953,80934,54581,49750,76246,263464
5DG2VcQkg2nDujoaxeun2wBszAPcrMiyX9HvaDKdPmddjKMy,10462,467251,292403,283037,0,1053153
5FnjYi5DP5kReMXBgs8tcRXX9sfERQVKEmYv2fHqbyKQgyDA,41589,1786024,1162476,1098686,1674169,5762944
5EkCnmNmqjmdQkCcSkxkpCwFLYA3Zt2CjcVM44pQ6evagFWa,8696,352531,0,0,0,361227
5HKyJUyK1X7Uh37YVwpNoDsWwZKxuLNurfJ4t8JSwGzvZL4j,2153,93189,60171,56409,85786,297708
5HYGAoai48DaEewL1QmCciAhDYrQxofjtTnUqgVuaRTKj2AT,2545,148009,71121,85763,129692,437130
5H1TftaMFsx3eJ1n9fVQRsS2LsDvYBu9Cjk6muuVtb7g516f,13953,0,0,0,0,13953
5FdsqnPNaJkkpWX282XmvK1TNdPWNReyGaSfepijMgE7N4yS,9705,471001,0,0,0,480706
5CSrZArVK9jQ8ypML64suSvDqucrwouQMKBsapQHWVkB5pSA,2484,113269,69426,67202,101163,353544
5H9SXjCFbdpbKg7PN26dRhNKPcbJVhKp8fsr8dHdqX1upsvb,3952,0,0,0,0,3952
5HBanxv7yzrki2eM1rrBWKkHfqu58k6Q8btnFdtjW7JdXSMz,2697,111757,75051,72647,109458,371610
5Fs4pL6aCQ7zDRKvibQYHebpYPh46YiwSwcMC18ccYupWv7g,3426,0,0,0,0,3426
5CSVoqQsHBN18SMsnUSV9qZamfUUQWEdqjCfv9uk6RH7Z43X,2957,0,0,0,0,2957
5EptFVwxKpeUtmYQYkP382K4Y6droaeCqQqUbsguhGUKUwok,14693,644141,410681,393647,0,1463162
5HihYqL9FvFCQU38j3Q2WyCTxRwdTBtRG2miJu88S2VFbkZV,2851,104290,79336,84473,119513,390463
5GBPDVVvRZkWCVtyswDiQUmq3Snz6YXUBWw7cydCBS3VmjfU,26619,1188923,744019,720189,0,2679750
5Hn6j2RwmWhQaCTzmdf955kd96kdMKfDVHc9Y3GNJPdG8gV9,13207,609456,369153,0,0,991816
5CrPhQnYHJkyLYPjWhSswiJUiLbsH1PxAyza22cfhkPhLHS7,65907,2508613,1842179,1735845,2651124,8803668
5Ff9qVDa6mKRJvPKPzKrKnqfy2JUjJ9iHzu9NCjKSMUPnsQY,28395,1161742,0,0,0,1190137
5ECou1fdNXsFbrnMuKb7SwmP1JtV7RpEazPXBPGMBPfHmBQ6,38182,1705251,1062651,1028616,1549832,5384532
5FUHDmG6pCtjJRKkzULfc7WTDXw6WPfNjHL8586yWkpedpi8,5428,0,0,0,0,5428
5CcYXY1QXT4YxrXCYmfugPBd3He5CAmniyWEfownqn9b8M2x,8123,0,0,0,0,8123
5FZ9NyGH9gSse8w4kSFC4cF1dqugK4GtYJ9vXyKvxKcpqntx,3319,137562,92381,89422,134733,457417
5G8sE9336F9kB4FrhpkHz6xZsVGmNcTVEq5KFf5gDt4Vmzo6,2326,0,0,0,0,2326
5Ge6kcjs4oELcGU2AoGaWWGU6kSnbzhiVTsakAf3tdycc9D2,4739,211641,0,0,0,216380
5FeRMvYbbFCPds14Vtp5hunNevAeng9GsmzeatoRBKGnFxL3,44767,2167158,1251294,1280887,1877594,6621700
5E9PhAz5BcZD6WiGW1v29jzq1h2xBL6ecQKP7aqfJzMJrLvG,5960,266165,166564,161230,0,599919
5FnqSQPxCk8BZ9w2R6NhPjdL9Fz4UZ4ppdE5BxbBnGEoKssq,6300,0,0,0,0,6300
5FNLoNYcPq2kVvNsSUvyNRtXfQ7TfCdTUgYv7TTyKsHXv2d5,2879,167432,80455,97018,146711,494495
5EChLpacUbeBAU62fCqUbNcL1mLcuvumxP3PjjXnZMPdYh9K,305454,12536188,8508801,0,0,21350443
5Gda1hVqErU4VCJcs1jYn962UfYTEieWGjBMX1QSStXTEH3G,19091,799609,531379,491774,754237,2596090
5FR5DPp7nGfGBGnbHWzdjxZ8DaXhavi5tH7jHrDmbCqZisza,143106,5917916,3444546,2116908,2849182,14471658
5Fse4WkjU2o7Jw3scTtvSzMfvNVnYDDbu376DwrZkAwVBAEp,320,17861,9297,8629,8494,44601
5HnHNGkXMyAfWwva6iTHaEd4FEXFZUCbCWBpd4m9fkstd5cG,1063,20369,32637,0,0,54069
5DM1csaTHsYj3JfeNkfreH4LoFCZWP1BVxS5tAuKecnUxYcp,531,18426,16299,13301,16103,64660
5GZTWTsuzaCEXnfoFPHWLDckR8t47dWe6GQaQXqK4pqq72jJ,1020,19534,31299,13172,15407,80432
5HTsCSTcJABpCoMQeN46ydGYUtB7hywHzkYFNV4CpafKu2GR,5759,205959,176834,92418,114168,595138
5DwQD4RbkvTxZSU645iZwnXjaGEq3YxgmmAs19GQobYnUjbQ,859,20049,26372,117025,158394,322699
5DZu4gkHLDB87dybkmn2ikTYk85bsx8P3NpyvDQ3JMgbBi8b,1186,66288,34503,325708,402342,830027
5Ckba8tr5RahbBo1Dus3VmbWJaHRCk2MFpTUPAEqdGf44T6z,344,6525,10001,3670,3627,24167
5H9WtamcctJ11KR3wKiDsPMrC8wc5BoSMk5Q32igzgkc1HHy,1852,72590,56847,30464,35907,197660
5EFHSi1yBCJKrt9kT7h91HDXENJBcLX7eYrXVDdxAtZXbXKw,654,20340,19022,0,0,40016
5FnaX7WRPEuzY7TVDWWFmXpk1QZf25VMuJEXXohmDX5eR1TH,362,20191,10509,9755,9602,50419
5GRc8iT57iAByjmVSxyGxBZFguZhpkkq1CA7tw2nH7rPRdAA,396,0,12160,5118,5986,23660
5FxnDqqNqWmkG5xAJaofR5ibSes6ga3MsWvQDqJuPzcCUvfY,479,26763,13930,12931,12728,66831
5HeX7H2KpRRzTrAPa1wofbyy3bk6HYhD9D18j6DWE95uRfmR,1105,43443,33932,18767,22611,119858
5HMxaZuyaA9LZ2r83d5EMqcexteW5da2nLsqQZLC1UzcVcZ2,570,31865,0,0,0,32435
5DaM5LxiTZcmyPdBNDHQ21TJQGHTcv9HB4nej7B7wKT9hju7,2467,1518463,706153,549081,490980,3267144
5EkGt9J1cKfPUxktStrB2LKdjYz2nw1ejKY6mzkFUo1CMK5Z,828,0,0,0,0,828
5EvtMZnRJDuwPYnEWU6ZGuo1buoXUyDaLPSRWCEUV1EXSj1Q,83222,3213784,2179272,1481338,1428539,8386155
5DUminryb1q3ShnL5skZ29nNZp6mFCJB9kp5bcuHDNNLkkJm,14664,680472,301712,357631,442314,1796793
5HikcFawehpuQpDwtfC6bo8KznvxW2qVM6A7tStfwPxsbKgD,12150,259818,248229,153532,186411,860140
5CffeJMS4jdPhaft7KLqzAPy7JK6HLM63FqBQGvA6nPdxVfj,36660,1701180,793970,894076,1105784,4531670
5FcGc1GfqDg4CVNwzsTkqy8NvSN9oN3wA5YbC9yeTc3yBEji,4146,0,0,0,0,4146
5HQMDcjGPSwQEMNdzQhPSPstJULaQma9tJwAm3yjtzH3Canr,84096,2388890,1718172,1387708,1614299,7193165
5DhLG946bUB94k9a4takEgv9NYBs1PLzNBxtvkVbXspNpoTQ,1536,30413,31372,17776,20615,101712
5FCKEQ2Zy4ovumjSWtmd7WLPupNsXMnBDRaeYK24oNYZM6Z8,7259,336834,157206,177027,218946,897272
5FprjVQ2LeTPAG1dR5bsb66xhskj3qYxCfTWDYZekspUntep,9344,241001,190900,108002,132184,681431
5FWoP56BJUYWmKbMrovqesMrHxCR7nhwYSSFuBf93cTes4kY,6251,192680,127714,116785,135566,578996
5F2MytKuXDujE7qdQaxJGj8ymfLtYemS3SFhU7EQdTLcpMhi,7442,147400,152045,90225,109608,506720
5HbVXV7wbP7t93usmjjy1xphYjg3zrrotbxFJRshdWnssNA6,26129,612358,533845,0,0,1172332
5HWWZhQ7229zgqA9sHjty24ypvq8taVErK5V6axcJMqHHkMw,186990,5090437,4049765,4527174,5529996,19384362
5CMKxHv1jPVMyU7wFCVp91K11UfA1XAKD6p7UgEiF6PcwuBL,7186,170326,146808,94325,112088,530733
5FLaDkJ8KnYoqLSWw67GBggautaUTXjPVuoeNGrrRNruDe5M,2897,53554,59178,30440,35695,181764
5G1wPJDtdqGDiqhqjEAtTvrUrEQR6TnBNgRjs1cZaKsuCByX,7332,189940,149801,101767,123367,572207
5FsnvpQSS9vkyZ8zybXJPDzbC9LdcPVxvQbvtfRMEKcRdLDx,19842,0,0,0,0,19842
5FNzYfy9z5AbxVMLA3CJVCrybUuZCGZr4sSAVaQ89tzceHKD,14664,680472,299602,357631,442314,1794683
5CG4zgYTKKB5mhXTfnJWkY7RsB4Vzv95Tz4F7wfG8nHNDTmG,22381,682968,452691,0,0,1158040
5CoD95NaUkp7y84aRpd3Trk3djZ4frPM52g8wpVm3Kv2USdi,22730,64196,30173,0,0,117099
5HaoZLYwkVtCFajTb1bAt2zBLk5WFfCxwUdKncYPp57RXC3s,6310,116652,128903,69759,81865,403489
5E4bqZ393LbBz8qZ7orchEdcGSjhj9edpJcyfhYEYFJBikko,28292,668191,578021,349808,441882,2066194
5EP2fsNqxUBdTT4ABhwqkKjQ1gLtrkJkuvksGMi9tohdpSfy,40064,939825,818534,492925,579133,2870481
5HNSACyoV4HAmvzyHUk1HLdHyWATVGaX4xtK9YmyDzhxreWu,1491,28099,30327,15072,18482,93471
5CaeaU9NtnE4FukU5a7z21N87P5HdtAGNmxf2X7P7HpAvR11,6746,502517,341044,214566,293048,1357921
5DqHbAGqwG1bEVog28pw3WjckoYdefUGCcyAEFfsnSLQarq5,2775,54951,56683,32117,37248,183774
5CmDmxFtACwF5SEnNXhkE7FTV1Ko1keXHqkzpPbuUeFodMwE,14664,680472,301712,357631,442314,1796793
5DUZajrmBwQv846T5HjSPXV3cSEBTQt6EzfvupWmDi9FA4wS,22071,505902,450917,276377,348532,1603799
5CJvYuY7ZSKEGHCG1mNqunvjvH5ZB3zGP7dVvxvbypWLhkBn,1467,64197,30173,0,0,95837
5ExvLHW8Uv2bw6uu8sLF1vDZtTUTjAwnx9XyHEXVgfCrDnPS,142625,4694692,3217346,2326625,2623947,13005235
5CQLZsEZDW9YSsXEy51SK2JScov4KjWzqmxFTbybr9ifJUkT,1395,45702,43481,19239,25250,135067
5ESCBG27TTMks1V9xcZ42wBDA3BD4e1Ui2ZTKdBeDUJwxicz,3081,413883,217702,213731,277791,1126188
5EnB9YF1yz5aq9v1eh31WoQVuUjCSQNxwg79uV6sBMbdkGKK,1031,0,0,0,0,1031
5G68CqM84zs1mCZxYnLHjr22AuG4G2mwavAESJrMHaB5jpwg,1031,17861,9297,8629,8494,45312
5CSzTUhdThvqANTFEYnp3JTYL4RyFintRpdDkbptWG9E5JeE,2621,68967,76210,39201,45969,232968
5E4R9FXDNz3TKCSozmFXHZuu5dNTECCQuD6MDz9F3AYp9xpe,3272,50126,0,0,0,53398
5CY6e9xL4KD2P6e9VbZCnZDvSSE7Aiq8UEu7WGhJjjsBd2pa,2061,0,0,0,0,2061
5DRccQBCkiqC5Ms23ZKkschAgw6YPaHbftzCXx16ocKcrExc,3271,120604,95118,64618,78334,361945
5Fsh1z8jZEzntpPLmBqENT8wJ4tBvpUWBziDf3x4jgZVyauX,2061,0,0,64348,0,66409
5DHqTEsnd5MtE237t8ehcfvdp77rYLsJwkonLjUApby6tGfJ,1031,0,0,0,0,1031
5C55Hepdvg7Y16SXvdemNesk2u3qtcwkMH7G88FcaHS3YkmU,2762,503602,214871,0,0,721235
5H19wpQAKYUrZi472UobF6v1BmoTD8NW6qvpW1twxQJ28FdM,1031,64200,30175,0,0,95406
5GQyS3kmEn1B24jrZQkGrghh6AZdTSyF9nvk78V9MhK8q92v,4537,148879,131365,0,0,284781
5CJgyrTMLnyuwSkYg5EnTATdCXrjYTvem9GJsH3cEy7MDKSF,7564,0,0,0,0,7564
5HQGMd9FcQLpDYBkAuPaaWo5icE1zAeF7LydZi7Ygqp2p4dn,8255,293462,241748,566621,593695,1703781
5C5ULqGGMpjuaDU1VjqAmfexQUunCiFKc76He6Fx2FE4Lorw,9761,347002,285849,167958,217865,1028435
5GbsqcMb1rpk5CV9TZZfWtT5yXknb1Ge9HW9g2oqtQz5gKjh,5427,200082,157800,107201,129955,600465
5H9LRV6b9yJeYfg6f8kN1BMgCSX6EStikc5Pj2kDURwCy5vw,17102,0,0,0,0,17102
5E9VAXvkwbERNwrRyytwFuUfKgbvuohxUKeSavsw7CWFw5r8,9518,0,0,0,0,9518
5DLMBnP7sh3vFnqCT2RmfmyY6y9fr2B9gKuETBL6FvR5p7Ua,14788,490968,461006,0,0,966762
5C5525Sdj1DahTw1XHNJpJi9cvJmuq97ty9SgQAP2ygEpPQG,11230,0,0,64348,0,75578
5DFZvWUUzKsPmbzKDjghjZayAT7evWDaDGUJuEJHZ1huAHhT,100177,0,0,0,0,100177
5CAq28gKdyhsLA1yKrbJwFhg7rKWLpXtJw2rMY6XnwYj7Ge3,3297,99783,66553,37367,57322,264322
5G1Ku5vFhjwueWr5arv8WZjsRZ9m1Av9NSCJ68RRNLHqTRpR,2716,82187,54816,30778,47213,217710
5E52jKjwf5SJpZLU9Pp1qK4z7xry9oA4VNTRr8VTqQgLZCYh,3175,96101,64097,35989,55207,254569
5FZMf21NEY1CB1Jhb2MqHo2zyAyTHMwECExt7qHKGsUDsvz8,976,9706,22041,2284,3435,38442
5EcXhAFUXNxSuwV1d18q5ViYZQdSKc5bmqs5AMi167ked1wj,6692,172306,151116,65434,95860,491408
5CPNMhcCNRErSYtrHS1iHvxuKuwwsY8vaV5tztcg697ENhKr,1056,10493,23827,2469,3713,41558
5FEX1j5Wn7rjLM8itQyKEgUJ8dNQGx1UrqkLbPDaKw8fqWcy,322,0,6701,0,0,7023
5CRxMeQnhQxrHR1QzowJR9Gdbe7sczDt9Xy64HNVu6Hgqb3Z,305,9206,6140,3448,5288,24387
5GBxdDS1vkwLjKvtCH1M8FK7N8p9eJmWBSGXuj7iH5GW6Fxz,4258,97414,96148,41632,52528,291980
5F41ZKuf3KpCEiKKXKcrzqedoh4vARNko17bQffy9H4wNCpG,1170,46423,0,0,0,47593
5ENsjrZmR5YYoxiteXkBDdXHzpnE7V9ydqN59yNtnUjZCaBp,1288,12801,26830,5865,7830,54614
5HdHxFr3eZwL6Y3DZepq8kFCRwzugeRGCcQ4sfLPpwj49T51,857,8523,17863,0,3016,30259
5E1XEAP3sQSrezp2tFSyRzXVDiRDJHoDm6wE4n7Z2QbMxcVw,609,7495,12678,2292,6589,29663
5GCR4cGResaAgvA2tAJHARSEybGXCncGBgwjFK3ob1Qs9ubw,990,9844,20632,2317,3484,37267
5CUkkpmyZ8BdFE2PG5QNxeQcK9kscY4naGoHEu4mHqPBCdb7,419,12672,8452,4746,7280,33569
5FgWMyV7w42fz7j6eWfSTKYLfEHDZVbe5tuW7ZExKVex6vyn,323,9753,6505,3653,5603,25837
5F7NJkTuJPBTVWNW7ZPtw419dMXCtDwWVpKCYEg9Wq61hGsK,2535,34223,52825,11546,15416,116545
5DviuYyQQAHTp2CZkPw7z3W9HLCxtpy5Bndto1uGMsJtCkFS,576,0,12003,0,2896,15475
5HMeyCJ83AqK2cfHPsgQL5VGCsDqhbieXLZbnSqTwDvyEJdn,368,0,7671,0,0,8039
5CaYgsaaQ6ikFYQ8cDXcmEATizngxQM1xyReJpfMq9Fk1Rov,305,0,6339,0,0,6644
5CoKrp6WzAtrmZ7cccMN3PpedFeBHcuauYcinWxuppBH3sGV,609,13143,12280,4607,7080,37719
5GnjfkMchuFR3d2B4ohxTy8GMQpUVPbnLDQdEfe2FpxHjaam,2486,33563,51805,11324,15118,114296
5Ctfzq3m65iGaYCVxb2FiidLVM69LtqE5umxhaBMitJvgfsN,368,7952,7429,0,0,15749
5DDF7MqbQKLWU5tSzWKFJvVtTdDFY4qSZvgSC2A2ZU3UMsYx,2130,28764,44399,9705,12957,97955
5C7vupYPAVUccSfSub5qccFP7tJQeR6yuyVC93eAqtbWrNRP,100352,2917937,2266325,1144219,1437626,7866459
5GQkvienyGHUCmCEkKRfm9DK35Y6QU3kmnsn51CKkXrDYQZW,329,0,6631,0,0,6960
5Gh2VLKejwut5L2fmCgstfh48HCLx7S5xs9WJE79ibm89YyS,397,12013,8013,4499,6901,31823
5CLZUaipQztBBiz824jxQneiVaouwnfC5SnfqpiJxptA76AG,761,9369,15349,0,0,25479
5DNodY3Sw4q8Z1Cyr34JYEnXKFomDgLjBmMeTyrRr4eViRQt,358,10829,7223,4056,6221,28687
5Gn8gbMDsdqKkxjLdkTEgmDjxDT611zSVz1ePsK3ZbtcHJAT,474,14338,9563,5370,8237,37982
5FQtSMtKDE48LQHMfV82uE1Ze6t3yPh98BTEfoboqcf4pFEX,549,16616,11083,6223,9545,44016
5Ckz5DwJFX7jQftFV4DPbQWf69acHycCoZk83mweUcmu85ZH,380,0,0,0,0,380
5E2fEq4pN63JFpyCVyhZhLuRkXbSvtsCMtRFEasPgR77zDjB,305,9206,6140,3448,5288,24387
5FPBymwgJSN5Vfun9mw2xC7p9UF3ZeVCRFXwbMPaq8uSSSUF,1747,52880,35269,19803,30378,140077
5GqJtqE214tnXfL7iVifMmHTzzvtVKBBKF8xMxLN5fLRvR3s,3707,58164,83717,36250,45737,227575
5Fpa4v3EdvDYfpP6BxCaYJhVfvetXrGYWYCvJDFJLNnyLMWh,943,9378,21296,0,3319,34936
5FhddCMorPtYpGEqq1LHGBzddvYJmyLG94SMxiUb2KNmjqZF,730,22093,14735,8274,12692,58524
5GTDXd6qbz6xbk4JqQ8uUkddLPm6w7wD7caSRrkgMV9sWkuF,11513,334748,259995,131266,164926,902448
5EFiyQexof2PcsTn4rbs7vZGPxAmiEX5vP7nX22hKSAb2Yi9,732,0,16520,0,0,17252
5Dy8gN4qzK8mYpXncN26USzY3usfuMFcSsXSaQW15AxbkAVi,1363,13550,30769,6208,8288,60178
5ERLNnnP6sap3SU3jco1gSqNahqNx7oLnX6df8u5WPLSVKzn,2599,35097,58694,11841,15810,124041
5GcCm8LzvGhdcYqou7MakYM7qvd2Z2nSYVpUi1d8gLuPBWVH,1556,47082,31403,17632,27047,124720
5DJBPiFhfYEV6YhFxrWvuQXYtug8fEi59QQXCzWww8Ay6vsV,1521,46026,30698,17236,26440,121921
5DaLAyQQJTHkdknfJNr22xcBK46BGHteyQsKJwyb1TS2V7G2,305,9210,82665,0,0,92180
5D89Ez9kD6kvADYfRAf93zKcw47iuDReMcic44ufHmD9dfid,700,21186,14130,0,0,36016
5G9dC7GUKpgqkfgsKxrkgNwF2ynv4rkSGEzkd1PB8ygdyyDG,417,12616,8415,4725,7248,33421
5HT8v3Fj44kvRf6KiS98TjpqhYjgD5MqRkmcAxoFDVku84Ad,1530,46301,30882,17339,26599,122651
5HarbwUwgBWeak1JQULBTjdrCT6SELMnH73kZwKMcJ684TST,3982,91092,80376,38931,49120,263501
5EPQHiayJtTVZaH4EQXfLNbXsVetZsc29kkoTSLzWMpnabkp,6609,170173,133422,64624,94673,469501
5DLQdXwnzpDcLR7dU8JpSTorTKF6Q8jqurub1Ev39ri66UyV,2281,30800,46047,10392,13874,103394
5E4BMQANZZSF6SupK5jr4Uk8EHht551tuhVsHdEF56zZsxCT,1330,40244,26842,15071,23119,106606
5DwTaLGd7rq9dgCeTVMDvBMMR2VigoHnQxoYDn19bioqKD8k,490,0,9885,0,0,10375
5CyZHFXWEdY3BEjFGDu9vTWSybWbmDSiu4pfTphjqBkr3SrY,305,9206,6140,3448,0,19099
5FeTMgm2VL1LGqDvaREchrry4KRY8q8jnEjLw4XrQqMCLdh6,499,0,10071,0,0,10570
5Cm8JHz75TZw5GAAwVV99qFJKPYtxXsP2hn811WpWLo4UDjG,243556,9944569,5854778,3272033,4928001,24242937
5CySgZqtpR2Cna2tXCg3ENU56y2ujYSFEnQ9X9X9Hh8pZSjZ,6062,249753,0,0,0,255815
5EWuRc6fJdAewTArojDb5X79RyoRqHS7GrjGzj2WjcS6nKUn,10437,430047,267282,227317,283716,1218799
5HYf3JpQKCMPW1nxdvN6sT6WQW7nUDxyL3JJq44CTVzGCU9q,7649,680472,317588,357631,442314,1805654
5F7XL2rt5XTvEFdkGafjzaht7jkhmqg7fnjh3r66SDtGzEGE,103254,9186372,4201445,4810628,5949737,24251436
5Fo1mRD8Rcji5CSPeMDhQLMAgeRDUGXN8s8qCkAxqweGZgK2,1157,13498,29627,6981,11488,62751
5EvyXXqdJbH7eBcp1a2jPZF2QCqqLwLUKqiAABBcvyWj4jFz,7649,680472,317588,357631,442314,1805654
5HKxdhD13ap8GAhkCE6KDUmtjaAH5vZsZLg1qdb1kgQGHk7x,1148,13386,29382,6923,11393,62232
5CSGyY7YJUyYMsJyi829dvMzDLRcSNKhCq5WcRYxfBDKYxXc,2358,97157,60385,51356,64098,275354
5EZXqzjpsABkgJvwZFKLCUJi49n3jHsY6pLbk2fgkgykYSxW,1530,17848,39176,12282,15191,86027
5GTwubXQPTay2PKKGBCFTQzk3dcc6gay1Y7ua3bSKDLWhtdG,8417,266954,215535,131069,163793,785768
5Fswq7AQeJwNbdDY5DLjdFcddmy9vJjLik1DrM7tiGCLanuc,918,36882,23506,16812,21953,100071
5GgNWiLXVt9xhC7PTwW2nie9J1JYZk6W9WndrWa4CF6B1jxt,1530,61470,39176,28019,36589,166784
5Ecp3jMUgzTXwyWB2tP6C5zEqgoMi3qkwHTDC6y17mAYbRCH,14742,365724,377533,174437,219509,1151945
5Ech4ywGCm4JP5FYGRj64FTVof1kJdhNGVmcQHHZNNMGwByv,8357,0,0,0,0,8357
5CzTj2DXVVjzPBVEfcXicKq3F3cjJSFBrpEcunit77LmfHXj,892,10397,22739,11377,14274,59679
5FZsRzks5woWPUVA47eKouZvjx6NR3pQAFoxdsj1BbeC67ap,3493,73223,89445,33503,49644,249308
5Dt6d5kFRHKuqQh9sAsVMxFnoKFDFcma86iS7GAMwtSW2wJY,84953,2779244,2175612,1322572,1703963,8066344
5DyhYCtLKsP3AcZETNBHWBWBdYNDPPQLr8RJckJ4M5G9fuVZ,3386,139511,86709,73744,91948,395298
5EZdvRZdaa6W4WX7Dtpd7qaBnv5KC7LCcHfaxWWqcKwYk1SU,1263,14733,32337,15639,20205,84177
5FkM1pSkGxHfx6UkUNVbw9MWGMFphGNn15qfkCwuVtr3Vp7v,1400,16333,35851,9470,13902,76956
5FHnnbgtShoF9BueR4RHrRkEBX3X9MGH2bgoVuJGGAHK69g9,4279,112093,109574,75460,98013,399419
5FNdY6g8gTSuDMAcoMr4GQSzq8ZAJMSXo2i8ZfFfs69VUJbM,39607,1122178,1014310,514285,645274,3335654
5FFFypBZkmirDzJNGbXseHw2scDRhec9n64nqUjbkWiX7hNu,5403,167627,138363,73528,95110,480031
5FQtxc86NYt5vajVPkVahpP91cuoXUZrSNbpUQGhVhbhtJek,3825,63670,97938,33772,50620,249825
5Fq66TGSa2tzieaYuQJLBfohmR8Jd2T1LW2n5v4jYUp8cEvE,765,31516,19588,16659,20792,89320
5EZox7jrPTfn1kG7jLpG94jH7jTQzctDde7iRpgGkvq6zCyo,3868,93857,99035,53981,67683,318424
5EvTmPudDAWt7GfP6xjM6gQvURFywRVsvt1FPJhhWyYHQZj8,3874,84673,99200,44609,56272,288628
5Deeb3ohXgkbR7WtMAChasSnWwRNRp4vhGqGB9YcWSGDP3Uz,842,9817,21547,5077,6363,43646
5DLdr9bNhZc2WeSawpR7Txp7YWLFuZkd5NTq9Vgr7xV5DvVX,453782,12344763,11597074,5567910,7017565,36981094
5E7sunjrvbmnD1C585KN9PC645EXa6D4SJF6AUhTFnBWRPWL,5176,144472,132539,65790,82991,430968
5GKikUAfGrvF8AHgsZXaVoWurjmpJstWajkDE7Qqd7JSxVsu,1148,46103,29382,21014,27442,125089
5CqZfdHnqaBaQW9ige3Jeu4psF4fp2gKJq8HRcJ8eJYmT1Y5,99794,3349973,2555543,1505089,1932249,9442648
5H6JRxw5QLn7kpo4k1sxxuBZekd1q45UxrD1erknCqhSKV3X,800,25368,20482,12455,15565,74670
5GKivP99rENepxDDEBTyiaakBUEtjMKdmuvKv7yf4QCKaRam,26885,651603,688502,310115,359441,2036546
5DnSmPbyMaDUNRWRrFCaWymstd3137jk3pd2KQcGuWdL9Yer,1530,17848,39176,13322,16738,88614
5F9ywhxziFF5oBXqznKXJD35hv5H3DhF9N2AhkfdpvBykWta,894,36798,0,0,0,37692
5CoZWcDxWD6mgz5eGTegZbLND5zhbyB3VBhfQYaSaKtfMjx6,3049,0,0,0,0,3049
5EZzxmJY5dyexnKsv8Q9xQY34Ugc56hjwM1CYCX8Nsinye2J,164329,4488481,3589910,2180639,2680558,13103917
5Dc7vvFzPkxezuwDt4RvbrR63t5rkXzWxqRDSyGLznrXCPxr,7874,191059,159808,169290,246190,774221
5CWwreekGhu2TDTvXpEq5YKyZgeQdSxqE1Jr8Zp3GWx7Xm9T,5920,157755,120641,133677,187770,605763
5En8RuZD13jirb7yzh2QxXz5SQLiz3bDTbAVmHVUk6B8dVgW,2162,48652,41061,27429,32831,152135
5EhFwFy4osWsk94RpKwApK1Yhykd696fmPt19hCJQZzYGGaY,18555,491521,729178,0,0,1239254
5FHjspqzXFTnSnndnjvLgBc4aYdesEGMjQ2sqNE8iYpttSik,1889,43625,35874,24945,33600,139933
5FsrT2PGUhrLtrfoC2yPw7Pq5xRuChm6Vy6kbb5daewJjRje,18101,0,0,0,0,18101
5EZhN3MfDzSDvguAWH87ccpLszoECG6sevZ2vddu3z3DLxjL,4366,0,0,0,0,4366
5DtATEHBBvrxW8hvZjdC2iTtEvDA3GRFFZH8TLUXRhLBjf5q,11133,249160,211510,152696,0,624499
5EeJ4Yp3cjBdwqiPU12LLw9txvVDaYaDrbehpviMcsqVJj9X,1856,53996,76569,79302,0,211723
5GixAE32p3snTLW3jwssKLucfQJio5Nuy7gWbcqcqb1CfEd5,425369,8337977,8081418,5425822,7115396,29385982
5FyDx7USBxw81VFLvFp2RF467PXhpPQD5EuAP7WLTQsb3q5H,40858,1045990,892098,1673303,2037542,5689791
5CZwaxz5g3XLxFo1KQ6sGMWAdQHgniCiu5huLqKuz995HCjs,2483,55873,47155,31500,37704,174715
5E2VaTPybd88K1xQQwQ1WoQszehXSEzmDeYTZ5h9WNXitLxh,2054,62457,39020,38438,54109,196078
5FbboXnNx9yqCGXgRDxYSbCKYwXkxmXSFc4vAocNYTakvQqZ,8499,227657,160789,132552,175724,705221
5CtY26VXnVgVbjHNqFRBK5cAXfc81gWhEDLVkgue2zGyPCHb,2172,41766,41248,30284,40028,155498
5HViqpv3eEzta4WTHC1z2LPAqe3qVz1LfPu2aWseS2M1PdW9,2379,53551,45195,30191,36136,167452
5GgzkfJZQtdoUi8LrUZh6NEDzGRV2vhfi8wp1s9oJ5dygHYm,1856,29125,35252,21059,27633,114925
5FPR7r2aRyyV6rBZykYFjfY95qybeC6jpyZhAyPDUXnzfyNc,4541,108494,86261,63332,83712,346340
5CzNgXq5BotBVZitpFG4nC5pz2mc7f38ozp87MGxjhWj7Xjc,7600,203562,143771,118522,157125,630580
5D2bFgdyhRDrgsG6BXycLRUJG5zXef7Vp2RdG5Bn6eTpB57C,3205,0,121612,150391,195597,470805
5HgJuhDJ5Wst5b5FuhUMFR7QsoXsCR6r6MwfG8r4KnM7hP5w,5653,115440,106942,113497,162640,504172
5DkTmcRSJj9e4gxoD3EmJWbspZJeQhjio2v9XDWsmEFcmt4Z,19557,1417433,807033,835841,0,3079864
5H6sZ8QnpeeTQAzoQqbaCHNTwxmfm9CN57tzG8JKJW53WkiB,2611,66752,49606,32395,41315,192679
5GP4F94bpxDLBtudgbdzhqcEhmgyiWNSjDpzC9tqfaXW8S5a,4236,107251,80465,60194,81762,333908
5Hj78S6G88VTAeHJtWHZG4QuyfMr1AyCUrRnRbpFnpymmMns,6838,182225,138769,153763,215984,697579
5CAF8B65PUoriXE1pjuawD8QeknSQJUNRWrjrPfkhkQjLPXu,9821,211920,189431,145514,196188,752874
5HiyZFydTsSG1SNeHXEjeErwHi2vDU1TMQtJc6jndvjPxkWM,61896,1369525,1351466,874484,1202654,4860025
5EAcGBRYxW6uqMVCfnZDvHxqwZEGwbfiH6ZPQCEZekMHJ2Yg,21794,463299,412308,264051,347683,1509135
5EKxuQcKXfw3pkSRCYMjcTCh6HdRsCU5LoxiN1FZ7qFCkSrH,176660,4752698,2975560,1923932,2498808,12327658
5GU7NYzQ3VYjFyU7fL5c8zs7WCP1AmLNHXMwp5sWnqwnd2E6,169786,5459743,4407216,3039705,3864791,16941241
5DCkHZDDwHoEUxGQiHezvPHqtvMysnaJvksvCka37NQABj3a,10571,405981,275551,234993,302300,1229396
5EAceNXdiSfD8XsRsVTUf28hTDXZGYNV5Jsjv926q7LMAhsb,21507,685926,558269,418839,537898,2222439
5CFiXfopns1nwgyU6RgWEF22bjdeNiwboK16i5V4DvZxgrXZ,3140,104298,81503,57937,81607,328485
5DXKgiSswWLFPVfEfBg49ZvdqXiS2hSrN74X437AoUTeVzCH,3154,0,0,0,0,3154
5Ew1t87EdoJNZX6EZj9zH8ZQmt48tTDDmafGYhgXqW6QyCji,215012,7563803,5604712,4170258,5616388,23170173
5CFQh6fZqKouK2yV81BFA1zMmHD4AaytQtztKMkjzZ4oYJZY,5911,217574,153430,120793,162928,660636
5CVA4zkM9TWbvUnK3ZBr4TkVVFtJnQPZkzUjcuYDgeWs3Hvd,3835,135780,99948,74880,100934,415377
5ConARJY1bpAEwbSTuPSuefVjPHXvb6ddytKK29tUqyrTC45,13392,523880,349078,276794,347040,1510184
5Dqkp9tjbZnUDQbXaYqnN3PvVYx31AZ5oLVH1rHZCeSwftpS,9415,349643,244383,194278,262075,1059794
5DfV4UAZe5VUBeJnsfN4vHSsMeiVYtQyF5hgGGYhTvnPfYpA,4852,217075,126452,123559,158857,630795
5CLq1biSVWGgpJJutY3VLfBAojEVd94vQZYWu1tVPyXyoxU2,10599,364011,356413,0,0,731023
5DXbpWzNLd5xWUwt8GLNgFGzCNcvaBta5iS8XzAgrpbtqFzQ,7265,0,0,0,0,7265
5EsQxwhNgzSdYJX93ev98zw2HKbBWYcGtxZ1q89WNeYGBuJc,11081,411520,287632,228660,308455,1247348
5Fn5RtCCMRcY18NqjMdVGAdXLyQt3UJqcoqAiaeaSsmACV44,3881,129226,101162,68891,91691,394851
5DCMqz8eckshPXZmivn8XjVMucyh48mn9kMtMrvEYD8wPC1s,7124,278691,0,0,0,285815
5E9PXBaphRWwKQicBbw1v3qnshd6bxS7hVXjJd3Lu7bo1Wc1,5190,192731,135278,107542,145071,585812
5F6eJvo5tNXwSfmqM9nJcLTnLcmmdAkzcZmJJVDwfGqsqYQN,15272,490337,396410,279800,375197,1557016
5GsdrPaWwSqon2oN1SApbEnTftqZZBD5gAfyVXgzNdXPBbuE,5518,0,0,0,0,5518
5HB6rVhBEHXF3GF8UJ5VCLE213Neqv21p5c9MeTAAbuErmL5,4985,0,0,0,0,4985
5C54fAT8LndTJkj82iAsV6ig4KizZhdsQQfjME4HCnva93v7,31532,0,0,0,0,31532
5EEeffxwK2ahbr6pHuYCTnV2YzzanX5SF6aZP1cS83LjQorJ,8361,0,0,0,0,8361
5EA2fCmjFqX5vsfGbgr4fwD7tq3m8ZCL2m86kK7q8VQd3y2A,9234,290276,240692,160686,200095,900983
5EEyBnb5uqGn2jeEUKA78TBeLYoEYH9eK13wvehpX4qPV8P5,38911,1445074,1010032,802949,1083153,4380119
5FWwvx4jFVfrHQFunJqsaAMarbxPTH5sMGRZ1nSaeYt9jbGS,7277,289849,189678,0,0,486804
5DPp8rjDAudXhRpbGYP3K17DxwVT7UqdMYvto5gS49y3CraK,20961,0,0,0,0,20961
5HWR2qNoL1iDKuMtv4wNWKud3CaAYKNWAH2c8NYwCBLvL5VQ,3494,113175,91064,68976,97348,374057
5F1RpWCH3Q2JqGgsRNDqxfSorVaUbJrMhTryvofR7cDW9cLa,27438,793659,715227,489964,633128,2659416
5EyLmMa3q1mEiJPDvdUkAK2j9KyhizDrnMqXhHQxmCAcAkZV,2426,108538,62961,0,0,173925
5DwVfsm8UpRzNYp49UVeAv8SywxYwhzCQVXo2biZdVH7u743,121637,4143257,3520602,0,0,7785496
5ELzR7cMNHkYo1H1g7aHo7bpBfD7iJXu5y3XpCbabN1ismzS,2426,103106,63226,54758,69432,292948
5Gq4UB4j7T9BE9QZmtPLHtoq1ecmFcj2K3JNg7sFqSj2vn8g,13370,411519,348495,256700,364206,1394290
5C5J16giWJjDP4KST93yC8vckMkudLakQfMs9xsi9n3XX2fx,2771,89265,72226,0,0,164262
5EASJaTTM3P4GAogFp6LwANQgMPeBaxTLef6qaECoDANssVh,7849,285258,204587,158115,211215,867024
5H4UJbqQrD8E99yU3zsBmsXkhziAYv7yoyqGS24PdL6VzX6K,149234,4952725,3150510,2159371,2729513,13141353
5GhLmqEQjoJZjTXLZYh69beacyGF9eZtL6WZPpU6QUNvzfD3,11056,235952,187141,86452,103938,624539
5D2vTWsJ6weqwJbrdmQFNGJ9vzpwh5EoLJiutpLCCt2e8LxC,16083,343247,272240,125765,151203,908538
5CJYPJiVXAHRrHYenZLMNhNfsyMVAmqD2EijddVExfo4NMUB,1368,0,23151,0,0,24519
5EHjsHgzwQrZ1E9LQR3jBmQYiYPKsCAC65AnDcJWPtEuDc8k,3357,71643,56822,26250,31559,189631
5GKZ5WpEDYS9G1yDBCRGVFMb7KWLP6HhHrJw5LeKFWSibC2q,14483,309101,245158,113254,136161,818157
5HgCagbbt1QHjutXdzyVjWmWq6kH5xCuUrizHVTuS3ZUcfD3,114148,2436202,1932230,892619,1073162,6448361
5Co249WzeBSmij38XjTWWwiAJTQPpFhmWTmrUvoccsTwsfbB,679,0,11485,0,0,12164
5HEe22mnUCvsDMDNgtr5QLB9mNBi74an4gFBRLfpkjs3wHMy,1663,0,28149,13004,15634,58450
5HVW1J8L3NYrSprvuq2oWLGZ9qU1J9o2vmKPYtJ9XtwYX6D6,5080,108418,85990,39724,47759,286971
5Dk345h8Kuq8gTmNBAE6D2siHcjQ8HtaxZrZRTVwax28PCaM,948,0,16031,0,0,16979
5FNzyMakPUgijRuahyrUoqXGLh9zRFnbwsYgUyTs93UEaHP9,1560,0,26393,12193,14659,54805
5HgZyNCEba2Rvi6ckJnCMX6Y9mvByBTDt3wyZypuCNben29b,3936,83987,66613,30773,36997,222306
5G24FQRfrnFFPecYtq9gnRUtEvWk43MGWEmARxVPdcn52nKy,3910,83444,66183,30574,36758,220869
5Ct9JDvXPKTf5WX54fBwXhWhBMvWNHuYeWLCZS8a8undRX4n,1671,35650,28275,13062,15704,94362
5CqUrgANLdEGStq2DHW1oNZPq1T9mfPTxQ6PUEj9GSBLmZgm,15631,333593,264583,122228,146950,882985
5Fvs6Beo8JA12R2VjGVdGqUrvHVohLGL6jnTP61Xy9TGFvJ4,601,0,10173,0,0,10774
5D1qPnEq6njV4i9DXpfbxoZxNKzCvhbf7ZAgPiPAMZH4qxYF,626,0,10584,0,0,11210
5FhHRT6fdhanwXm9aRi4GPdTkoL7ihhxVc8kkWQYDBEmQtzN,2681,57205,45371,20960,0,126217
5Dr3Frqop2QpaE8ZFLZYzSJ5uQmbq7kpBQNPj71rKkpJdq3G,15278,326061,258609,119468,143632,863048
5FxoVAB5d9djjADL9L3iqRp5KRnGvXPKDtpD1ajDCkojquQy,1006,0,17018,0,0,18024
5EtLtb7P15KctmEhVErAXCT5Lg8KivqdpTro8gpVsDVgo9dX,1968,41994,33307,15387,18499,111155
5Fsb7r1ynPuK4ZJn8F4nUL8T3Zf2N6sDu4qRRjKiu5hDSBxM,1269,0,21475,0,0,22744
5EX7Ze2K1wyvUNuRcDzh8hxs4pGFvcUAobmhMHo81Qf5fsYu,2479,52891,41950,19379,23299,139998
5CLhEgh9rqvBAXiqj5UyD3WY5We6n2zy5mLwWS6mLqXGAVCr,2339,49899,39577,18283,21981,132079
5E75DCy2Prd34HNc8PpFgEDXGDcvnBjyvkNM477xKqgQPUwU,4080,87068,69057,31902,38354,230461
5DkrtVE4TuqgqnbPskc1sNDDi7qiUhscLkxoRJqSpDZtepSj,2862,61069,48436,22376,26902,161645
5CVE9kemkn4ErVvFyqBuKJQckK1nxjHrC5EPqxM7vNyumXTY,6392,136403,108186,49978,60087,361046
5DUix4vKdth56vNYpnzwuHUM8TeooMDVwdmjrmVD4687skWQ,12293,262353,208081,96126,115569,694422
5E2L75LpgAwpnR43h5jMQGSGSmXEUf5WnozMPojYSBnVpeGs,1833,39113,31022,14331,17230,103529
5DskYC7PjxY1XhJpGWUXgUd2xdTs1jsbxvXFu1UUmy2QBE4R,782,0,13230,0,0,14012
5Fpyp5R21NP3WvEcym7jGEWwReHozHhHsQmS7AJL2kgvUZo4,6396,136489,108254,50009,0,301148
5FekRQWDAuu8c8sZAUGNBZakMEwcbh2TP5YrdvekqxG1a2vE,9057,193300,153312,70825,85150,511644
5HTvvSJTxrjyem3wg2ug15sFaYjmTgcHiPKsWFpy784kn3XC,1954,41700,33073,15279,18369,110375
5DkACvAkRo6P3CPPESKNvvBZJu2rogGN1sawmEwc266b43P3,1303,0,22049,0,0,23352
5Gmq9J8gFtfCwgnJ8G6B4nZp7E2JqvynUmtCyXvxvd5DgsSj,1734,36995,29342,13555,16297,97923
5CtZ1fwJUu5eEHCCc3442Uc5VSNfrGL4HQFD279NA8ikGpxB,782,0,13230,0,0,14012
5CJHFqPJq6oHiMFGMqETxVFW7GhRxR8k45Ero6isSFHRTt3J,1791,38224,30317,14006,16838,101176
5EkLoFmTbcDhXvX4UJhqDPZHkU5n78VpDDZLF8fSFKU3WjDf,1372,0,23208,0,0,24580
5GYsvfTsyR3jTKsVxGatrBQdRHGRvHA3kgC7knsyg15P4Z3P,2563,54693,43379,20040,24093,144768
5H9ZQ7vKdb6QxLnF6woJaUaBb4NaXQnSFa5WWuYxzjSWPG33,1112,0,18815,0,0,19927
5DfK8whTzmdZx6XG8wSPBqP45g4DVbr82VNkrJ1rgz68RixP,391,0,0,0,0,391
5DXgJrKHnKPuySsCuSkeMQRohk55qGE9bEhoPAPdqv4oEvqo,782,0,13230,0,0,14012
5Hg5SunBLoRSAA76zUyDDUcw7vnJNeVJHsuaLZyxrYb4XP4c,5600,119502,94781,43786,52642,316311
5FqebMGhE93wY6ibbohSpSWwVzW72TKTNFPZxeAfWSGoLsn1,1564,0,26459,12223,14695,54941
5EnD6mzVsUSwGk1WJTxJRDSMmhoL6feJkQpF5U1CECZk1j6h,6079,129724,102889,47531,57145,343368
5ERoYJNVatg6pr33TzBJXXc74Ai82kYypsVbhcvBRW2TZS2k,5221,111419,88370,40824,49081,294915
5FWpmXTC31ftEvrMmYq2pYKqTFzrbrkhNV4NfKrLGGXJwPUu,846,0,14317,0,0,15163
5Df9xP4JKSiF1JvobhyKENgc9SYAM8pujLFBqArB8oFtTMjA,919,0,15554,0,0,16473
5GWR8z8M8wmeWDHJUQ96n5QMPVbt66HQfveoKimt6GdgupkL,608,0,10286,0,0,10894
5DPRzVYDFDzaZDV7JjCAJrxody8iomBi8HubvLHEvTt5YSNz,3185,67966,53906,0,0,125057
5HibtoSfrbX99HhWtXci7HB2sSbNgZGK8jTbCQw5orB5diV9,530,0,8963,0,0,9493
5F6tRk6TyPLLkcbjVJq4hWkPY8FXBRbd1ncbRJasDUJjSubJ,391,0,6616,0,0,7007
5GeqE7qwsjSSqLv1Gb562xKmTrzgMUzhL2PGHSnpm2zxL2Di,79715,1701320,1349371,623360,749442,4503208
5EJ2utz9WB5c7yNyGZwGY7xcB79zUtMfCaJP6ipQUdoCctLt,4853,103571,82146,37949,45624,274143
5CFypkSFrD6yzSm5rekWmmd7wTSDnEH5nYRWz7K82RYguKDp,670,0,156563,116429,121745,395407
5DD3NjxTQo71FmVAHnGVapkgA5kRxHb5vNyZbnNyvUuEtH8s,1954,41700,33073,15279,18369,110375
5GnHfkqxuHzqCVrh67c9VMKmyuULuWZbVd96TEXTtUkGh8Fp,2646,56469,44788,20691,24875,149469
5F1PC1FVS8XARQVJSG76oCnVfSN9SFas4txq4RKTjeoqNWF1,516,0,8718,0,0,9234
5GTECpskUGbgDvnNZVSxZbxMxFZToqTyG6hzWqnqGQVDwtMK,1359,0,22991,0,0,24350
5GrwnfzrwkFxYFmRkqG4sPZ985h43QYvB9ra2NBAGdc2PTqc,3041,64896,51471,23778,28587,171773
5EKsgRX9DzPqoXy6xtqqt9ygThVrnqrVKBVz6s5kjNq2mq5U,12180,259934,206162,95240,114503,688019
5G23MR3HGE3uMg9d6A5pGQJ8GNedHQoocSHQG2uH7qyrj7JE,411,0,6946,0,0,7357
5FBvem1iKxnDKW5RKvCys43dFwddLsfWhXUpWyUnc6qREgb8,1575,22911,0,0,0,24486
5Dhjz8JLFgEY8vRQogPKspmY9k5cY6SHo5sdbdv2Zrxiw37n,735,0,12426,0,0,13161
5Hjk2zhr3ZB368xdkVCASFAABCKFL8jbKvvQxkd5otJTDnkr,792,0,13392,0,0,14184
5F9DF2Kaxj8dxLjhCHXjmrTPk4arzKBBp23SNerqmdXfKFq9,4643,99083,78586,36304,43647,262263
5ChUcgeUSeWyt2mnYLVQqrexkquDGcnjYAr7uezg3ERCSYt4,904,0,15295,0,0,16199
5FL5rxqm272fex1ik4zgKKr3bmuveJ1uNvnFhHYkVRHNwkw3,3908,83399,66146,30557,36738,220748
5EPCvGy1hxKqMAUHQTTvk1ZmRa1Q9eRqcai187b65eAnWNTL,11742,250600,198759,91820,110391,663312
5DRQQTrNCUNYBFrDGHwApEqjLRpjYKH5HraAGuvUfdLDNEyP,8329,177751,140980,65128,78301,470489
5DLUi9s9DJAZpmauDpweXZR4KEQyknzEQqqsp7Bk55uyZBkB,7020,149807,118817,54889,65991,396524
5CSGSzi8m58nj9vRzN1tEgB95CFC3ENKpo9zr88eHfNegEmr,3127,66720,52918,24446,29391,176602
5D2nwjuLGBXh14ayKr8BXkrwZpHHYFV16jrHnY8mZnM8hH6L,11645,248526,197114,91060,109477,657822
5DcW99iCXtAzNDzffDdQYFjdQ5GjXsHbWNTSP3U8PZjjv4wP,19538,416991,330729,152785,183687,1103730
5CaEb1Lqv6pqucWoVAoUaJtu5Hx1H9CWEzvm2P7oZfzjijTv,2026,43232,34289,15841,19044,114432
5HmEespZ3RRwxYoezjm2WHtmkwAyk14DbfFgcquqLzwCp1ef,3116,66494,52739,24364,29291,176004
5F4M8CviMaAoaEyaWKNS2zN9nbAam9Af9SmXwNbuAYs26m77,912,0,15426,0,0,16338
5CXZzH9xs43YXQ3MdkZAXqtucJyv2uSVdbGJChoro2fW2j9j,628,0,10616,0,0,11244
5GYgevdoo7NBbig71qqcHXpCcg5Df6xj1WAjY8AQw9kHoN8W,9724,174630,164588,65955,77448,492345
5FvcZvjmUhp1hUgfjyGjQUzsMWsTtntST4KqA26nDheU4gMu,2111,45036,35719,16501,19839,119206
5CJLsmpYYpuJkMtwiTadwPZYhDFEfmA7jx1s7nhN7eJpKHcf,513,0,8678,0,0,9191
5CFGVwaqMnxDDg4mh4NyH9ByvY35C3koH3d6RDXpm1N1yCnV,1621,0,27430,12672,15235,56958
5FjAxAkk7aBiZhGNbR3BCce5YU69WiDz3SuMRVirsHEwVhQa,1954,41700,33073,15279,18369,110375
5DwXSabaGEw7kTmERLfEWdqJLcKVynxtykLxnaNqsassKgeR,4768,101747,80699,37280,44820,269314
5DjmZ5KWiE3gr5wXidz1YMRENVdLiMRcd8Gj6jCNbrqiULe7,1833,39120,31027,14334,17233,103547
5G4K878npLzkGEKBwRQeFvBkgZ5kzvrcHRpY1EnzBdpuowRK,7816,166797,132292,0,0,306905
5HVtQGrszXVUpv2U6TB3oubxdAevgd3K2GVev2LzHyzReQZy,3107,66303,52587,24293,29207,175497
5GHDvB8WTrBcSGUWA93HWFa6RVpE1SguVE2xtHNeYFX18gPX,15631,333593,264583,122228,146950,882985
5FCwwQsDH4f2HAeqFqtT6tp55Aub131rpsAzf1M5NcHUwc1A,225940,4822125,3824581,1766814,2124176,12763636
5HTQQZ3FFYXx9c4pdKYAxUZNtWwk5KA9zmnT2VY39e2un6NF,1763,37613,29832,13782,16569,99559
5F6uovDjk9X9uDUbpvSz93do4gkWZZcKSUbNjDTzDNTkcnrQ,626,0,10584,0,0,11210
5EA4C85Yik9hJLJYz2eq3qohaPTQnJ1827P8c1s3QjLXkr4X,1880,40122,31823,14701,17674,106200
5HYU9oZKd5PrHQiA1yAi2yuPD7aLSwNdQuSBUiafpk66eX12,1853,39546,31366,14490,17421,104676
5E7i22R3BHqZBrAb92tJvha5EKokcxNQMQXBUSpDZpesCzTe,1971,42063,33361,15412,18529,111336
5Gswgq6eopCwsA2UKxuzTtSgiQiF4Mze9XDKZdxEKQ2pmUwM,1034,0,17497,0,0,18531
5DedvpHT8Vh5u7EZrwC3wNKcuLM9vJBprfvtiR6KT1TAUFPK,2103,44869,35587,16440,19765,118764
5DteRS4Tg6hKGjDdCivj1pvtsECZcakFpQkduMZKDnxG3jdZ,21388,456471,362042,167250,201079,1208230
5HN7KymiQYB9VH5ZdiKos3ttJKp4FSkjaUUsYKxTTWzmwaxW,452,197839,97709,0,0,296000
5Cr7UN67PHVHMqQCYbXP1Tg1Czqsckbimx3ViGJum5PRGuk9,3908,83399,66146,30557,36738,220748
5DUKJtERu4mCUY87jayh48CexYkwmgctdH5XDnBFR997RYcA,7606,162322,128743,59475,71504,429650
5EaB5aFfaktxrjTGr4yLuDrv3gdiUtnrjWECqQBrXKjpun9H,4632,98853,78404,36220,43546,261655
5FnUXhnC7yGTognMkRdA7UUtogXngAzWtsvZSnxcisqCReNi,3565,76079,60341,27875,0,167860
5F51d9hkoYoBbrdLiodzYqsZwgzhQANcEGWKaNDidVfcf28Y,774,0,13086,0,0,13860
5EnAfqaatMVLETbJGYD7SbBWGd12su6AQVn3LgsfEDxHuUki,1152,0,19484,0,0,20636
5GNCLEMQNbhFD31v5r2mXNEmgKcB8tpZu8AG4oXaQxA3h9e5,24063,513563,407323,188168,226228,1359345
5Cew6f6TEujYprLDBaHCW9swkmFLc2SyzRiRp5K5NX8tWLQj,460,0,7782,0,0,8242
5Fmz2CMGyejVNpVbTLNz5RbE6rLtxmFjhVEgfoJynstoUr8P,1626,0,27517,12712,15283,57138
5GeDEaiJSJbVh54hKb32E2fruUkyvGgiC5rHcf6CoKVBLKoK,892,0,15097,0,0,15989
5CFWX6RvU4YRy9JtspgSbUVmLQN9Pp9rqsuv4GkxCrxao6vF,398,0,6727,0,0,7125
5EyL5TXQ3LXinLxASayUxft4NNmviDcdZ6YXzmocVrnTPBBB,1586,0,26845,12402,14910,55743
5DS9uiXYV32e38Gmfran26ri6q6SQ46fxktfJg5xLApdbyz3,4492,95870,76038,35127,42232,253759
5GU1ceQgErFGEjf7Fv5wFCG4f7tTEpbF7RgBBJUoJEGqjS3B,405,0,6851,0,0,7256
5H92J3fBrG29jwMveWmqoKtH2TbmEXUiAXSanPezTZYECtEU,3005,64134,50866,23499,28252,169756
5GFFyDWvaZGxQfQCqSU499jgaZLbJPip9cJq2ATLvtkAYR71,3929,83843,66498,30720,36933,221923
5Gb4yzgkZkKQ65G6JwuNjvgS6QYn9FXF4Biip6x7fe696KzT,3592,76661,60802,28089,33770,202914
5FL84CQyc3dcfsdL4Q1SXszNngm2VcbFrQW2DqVTMFJmFh2C,16055,342646,271763,125545,150938,906947
5G6QV7BsAr4Tv3otuf6jWtVufDaC9VusB7auNeNrjqAmeeMb,13070,278940,221236,102203,122875,738324
5EHYnK8rREfzg2wtkyFUjkSkA1Nj851yx1HYmtUYUie4i58N,6099,130158,103233,47690,57336,344516
5CkFv4k8Se1LsCXw7VYBBcaVx8ZpK1djm66qvERJszmzBjTJ,437,0,7386,0,0,7823
5HViAhMGcWauKeXNDvZhsyQJGWCJKHXqMuZhRNSirCqF7y8F,391,0,6615,0,0,7006
5Ehh5j9MKoMa1xxqW4eB2AZiwF2V2rQbcUoA7uctbo8ADg54,3127,56146,52917,611340,798694,1522224
5DLRexmoZHA8b3KoKhrYgyoMyHTG9QjCeGuzecSj9YiykrGP,1237,0,20933,0,0,22170
5D4jJGKPRiCyb7Zftu8xjhyTAJoD7EhVWU9bNmNRKAPimJpe,1586,0,26845,12402,14910,55743
5E9hjo2JPR5iaCMT7gKdqi3S7e2qNwYWu1KWenFvxdnfNX65,58614,1250971,992185,0,0,2301770
5GxurW3UPkx28YsPSWpxAAFEY324Q72TA19YTRymQ6eBW6yg,4940,105413,83607,38623,46435,279018
5GeehdvvWUmgBBjDdfsajEJKvcWWusSXwt7aftLBdDnVFR6v,4052,86471,68583,31683,38091,228880
5DfBQtFnS6ameG1u6gnSzX39WE2i2j3poK9aPBFsctVXkaan,54913,1927178,990237,694327,826398,4493053
5GitTxSRhD41ty9P3wdi5votw6UuAFe1GsFaLxYxVmuGkcsr,8431,210185,150183,106262,137493,612554
5FjJbyBGPPQkEXGVBeQUfuUqEEgGLCxU51YaYvUjxFXwmmmN,13444,335156,239479,169442,219242,976763
5Ci4FjLxhKFPvvwCWbNW1nT8cJ6VdHYjqoNEJjd9AxJxmw8a,2991,50017,53271,24539,31647,162465
5FRS8fa175FjCT4rKKD5zznhmodmvygPqtL5KMkGxcxQLbzk,2431,60586,43291,30630,39633,176571
5F6SDGagQNpQR3TJPQPWgUrnFM31h7vE7KtRWmBXR8KL4X9D,12974,323433,231102,0,0,567509
5H1LYuw4CQpQibK16Kh1F8NX7bmX9QCXQdN5a2jFMcYdPvUS,509831,10246327,9252960,4941699,6452184,31403001
5DJG3CGL55pucKL432h4rjHgPbXXiAWxdU4rzqwR3JU1GGZF,4645,102525,82728,49526,64315,303739
5EhwpTzmJtgYjF8cwZ5zTXKTr3C9W8WmwsvyfMUoUegfYHhJ,75965,1708390,1353209,822037,0,3959601
5E4h6mf5mUs8Cr2EsGD6MM1NkDcuYucLHyS3MkTFCARJw3Nj,37388,797904,666009,408211,528949,2438461
5DLMgLPhPMVnnTr8hHgbQUeQQA9cvsfyZziaPH7jnuTA91WZ,23820,593831,424310,300219,388455,1730635
5FFYRueosHcWtrh8PVJiVfhpSrhXNWFMzhakAnEzyp6DUQAt,2920,72791,52011,36801,47616,212139
5EkChLz1FL7pBs6UzmemVFKbBgxpL6w2whKqJwQ56wQyeQVE,165264,4354939,3251447,2016339,2529699,12317688
5FCFmtNN8XvDQ7cdBTMnXHb6oNF7qZBpPVbrvJPbYhKS7wfV,2165,59169,49490,52427,74919,238170
5FTbDKsxX17cYUChF5ZuPsQLRGwheNmS2nTcMZ1XUCKEUXsk,32941,979629,0,0,0,1012570
5DiEM4CuDQx4FL7FKtbJQ7F9j46KeDXr4xfctp9FqnqSdqnQ,5054,115561,109360,119503,161053,510531
5FYtCYXSa4JaoD5LRB3JdcJrrvzbLBxV6EWxdNqd54NB9722,20424,532669,441958,341635,463167,1799853
5EKw4qeoVkt8xwKNCVm9yQx97i57HkFLErs9bhUE752h1N8W,2444,72659,0,0,0,75103
5He1WAnLcjxc9WSRkWsj6pD9PiCT1TqYp3MMJDkAFK7xiete,16471,407012,412441,0,0,835924
5Eo7hU5qBhp62NuerGASkH1Giq57YqDWS8PxseZ99o1mF9VF,376021,8303426,9210411,5388700,7066714,30345272
5C8Zfr52hHc4Czzi9RJoZKANFoqydFgKHwe8abyqnfoGAvXs,3801,113024,81001,69607,96749,364182
5DfAKqssoawzoKCsPJQJBTXMnjYnE19Tz9mR88ctsw6gjHLs,2452,52140,60034,0,0,114626
5HWXmXkt6ojrWhUH1BY4Btp1EzNZN4vBchBQU9bq2Sha1CxH,32942,836155,705035,1471301,150820,3196253
5Fxmc5XthJ8Y41CGt8ZfkcKzUeMuKzCsmNJvnGkGjX9uTXRX,8236,2942129,1998693,1705496,2077182,8731736
5Hp8BiXPqUvxX5APcSrhYhyZn3tiitrrd6RZRtxXbGfx1uXW,4047,81688,99540,0,0,185275
5DFKnWrcTRy67CVAzC71KVBY3Dv7mXP2kf7TPMu9M7eAQc3G,28430,973943,1571814,1341237,1633538,5548962
5HYWYeT22mM7ywBpqPugcaSQ8ucKP5ApgfYSkW4HQz12ZrHC,12240,426076,299797,281292,391457,1410862
5HNaYBEyT8PhrbHBfkKMRmWKo1H6a9eyus81CnWUPfD8kaS5,44619,1553253,1097514,1352988,1779147,5827521
5GGbTTaBwV2SpPPCGKF8sd7BP5efhVFKcigaYvPBxX7A66zL,9432,270784,231021,161051,216522,888810
5DMQRPiZgyVKaNvxuvs8pGof5mwAepF3YSNvAzSUfKxLBV8j,6589,155690,162055,153358,206831,684523
5GngPvtN3nTmHX54ZuMugxRZARP1iYFoHMEA7NX1SLi3EBKi,2058,70503,50622,43390,61080,227653
5FgquJ2av2AaWpAbtykWHnf6WgKKTTcYFK7N6rwUuCq7UCca,1648,40606,35793,43480,57730,179257
5H3FwFjuHV2AFxPYNTLWmBbbv5EsrwTNGFbwnKbHFbUBiX4C,7630,209875,186870,184223,262889,851487
5HY2xehrcUgCjTQYotJWuJDVtUnZq9vAsgVJh6WH86X52NyC,16687,477148,408719,308605,430082,1641241
5E4zsak5zZBbUZryBmYvF9n5GRma8Lob8M9q6oY7BoArnfqG,156842,4852369,3420178,1920985,2679914,13030288
5CFrzD2JSioawt4johAa9xSF2eHRmrWgUj1m8h37FeCVPBeZ,3258,132064,74144,61790,78612,349868
5GnUgf2okJDWbiqtCP6rtF86VqBTFKDg5VqqnkBfT3gmPZME,9774,422989,212118,0,0,644881
5EsWNQcTeSSoPubvdceFQXU3yPkr4iNUfahAhuuzeToduxzH,6842,392010,150410,173384,222252,944898
5FxnzrocywKuypWxEUAj6woRw7TpBTYub4CToqXUzmRu9NGz,3258,98747,74144,54137,75268,305554
5DPqwZk7ABQrrTzTgwFK1e2YHVyRSB8YDMevv3APoZF7hHcT,111378,3963897,2534723,2318183,2782440,11710621
5EP5NzagAxELGmAX1QU8RRFd1WGpbZYJx3sAocFPkC5Sk6gT,93609,3096755,2130350,1604729,2141642,9067085
5Fc6vyxHqo6JLea6S3pdw62AgvzvWzZRTFBiorEK1nxLhcEq,3584,0,0,0,0,3584
5E2cqX9BHQNryAuquiaQH9anoJcoNqrzVwWfjKDAXXDfm4tC,7168,307588,155553,159142,194879,824330
5FTdafcWadXSRBb4oYac1BmDbhZnBnfi36oaR4aFkdpgje52,35945,1603358,916390,0,0,2555693
5FU7xGTj1cqzm5sAudQFt24sDtKed5EdEUGTj1UujNQ64Lb5,289911,13966261,6597786,5825526,7254673,33934157
5F4N2qxzGGhR1vKU7rRedA5H2219rAUnRQ6d3qjoZonBkEik,307691,12305528,7329044,7075937,8560472,35578672
5FA7jmMVg8Rs6BUv56rYKXRXLm98jE2k618FHPpQ9PvhQMHo,130413,5167787,3227741,1913474,2502070,12941485
5Gs84Q5R6mKFBM8SG8ZLfxBphevY2EAhc9BUZLh1VKLPZ9FM,3971,144774,92520,73738,89375,404378
5Df6BToxhuAX9Mru5wveMKpvUuYmfE6JaQ7J1L2NgAqcMFvd,5956,217160,129012,110607,0,462735
5F55QuxV682tctPGVR66GbRhrQLYq1yo2oBoseEEPrDTjPQC,35642,1417444,772060,758042,0,2983188
5Hovxfst2dnvccqS7V52PESSbM5TfxrPfTQn6LGd3Tpvphep,40426,1776908,941975,936697,1120062,4816068
5FKmaEwc7ELooHnJAhXBYMMeqxNkGz8K7faCEVe6v5nstivB,3563,129909,77178,66167,80198,357015
5CDaekB4CkTMCc951dW6DFcfPY79vMa5ZdcdxdBrvL5srYjN,4257,150023,99192,73382,94342,421196
5G6k3qGzdP41u63Ftdb2brRBFejguzwi3dvtHzCoHVEeVdsH,7126,0,0,0,0,7126
5CypTaFf6qsQESJKNQkUA6cs6TRdNfs1FTTApMtoisrPRGot,141903,4379976,3596631,2163178,2778595,13060283
5D2bWZvimSmHMQziUSqBHGVFhwcSJUyrSdc96sJp3DPY44Cc,0,95382,72918,49945,65676,283921
5GLHqjeGyqFvoerG2USeAgZMTEq3y7v4KE96UMbqpYQV3UdE,0,152106,81035,0,0,233141
5HpL5tHAJ8B8f1JjZvxWAM2Ck3vn2daso2E4765b2aLMXxQL,0,5258224,2980717,2622081,3195569,14056591
5CesDiEeJbidjWWurXfy1HH3yqdJd3bEfuJkFDyVfJFaoQiA,0,4718687,3677327,0,0,8396014
5E4it9GoJYdm4V64dzoh6Azut9KUXWZAJfHRmdbFNqhzDfHs,0,1734548,813116,0,0,2547664
5CoiB5gjk1ccSLpevFPAjw58zkFiZtokQr6N77jwV8fNi1ky,0,1658804,895058,0,0,2553862
5DaSTwhParBxMFwCo6b7aSFh9pfMKacfki9TkZSs4pmN4wm2,0,5076426,3781074,2069032,2524691,13451223
5CJoGWxLYyqJ7VCLJya3SuTSiqePTBLQ6eKYdzfHWgG8cNea,0,1730024,1004714,1977291,2814314,7526343
5CS75e1T3PcDYpijPQdjwYqpf4LVH6sV8HByAo4unhaanewo,0,1815352,1181538,2019120,0,5016010
5FbNsEK8JG2BbZDmzTQ7ZAoMZvhPSTzKRjcLyVacmWAKsNxw,0,2151288,935518,0,0,3086806
5Haj7HQQJUZCJZZiVxMoTMizasH2VUtVCqNgsRK32W1vZqRW,0,1924760,1252964,2530921,2562570,8271215
5EcR7ZnsTPCGM2kTQ1C1cxHYQfL1ZgcHSjLUukC8GmD87Gkt,0,127693,64166,47440,64067,303366
5Evi5DL4PPBQGgrJzW7rqUVHoZTByQhuE6QyabGM1DPQC6Nz,0,6383696,3410975,1970290,2428355,14193316
5EJ1g4VLWzvoaZ3pKVJbwY7W2zjWKMzhdFvhXB7i394neDyr,0,97248,63389,0,0,160637
5G23iUgMscn2afQeLeG9Ta4Jub6vSqGzRniFY8PJ4nsV6wao,0,5799007,3701104,1978362,2441121,13919594
5FsfUWKCca3FYTgqdCCKfDzkKGnw1n21wTbG55JgjUfsQQgM,0,5517468,0,0,0,5517468
5CfvZypWT1yrwg2aCrsL3an2JsUFUExBD3n23i7iU4yGJwZu,0,135671,96941,68590,88749,389951
5ELPfQexXvsDSVFJdvvMYGUdFNWZUeQ7cys6JX9NMpfcKt2u,0,0,5602,0,0,5602
5GU9xCww2Rbn9LyARPNRsPKXE5FmPcDkx5J7boUdxx75jeqj,0,0,392034,219780,250772,862586
5DkDtksnVDdprs4k5riZGuadWjcWdYEQAiXx2w48WXvQ8nip,0,0,1359233,1007391,1242128,3608752
5FesxsKCkxLmpCRsnf3VRRkQiWRafNiFMR7dLq5SvcFsYqXk,0,0,1588849,0,0,1588849
5C5CP45j9HghVPtUuo2BrPg36dkavcsi1ddTr5inwyD9689u,0,0,41734,47358,58314,147406
5HNP1byeJWD6De5teQDSjzFPDp7zjHBEwUm568TTgmevTHfP,0,0,26364,12185,13593,52142
5EAHPaDm83GTuyaEyehYtVHrEx1ZwbVU3ctsPvxK5CfKQatg,0,0,129682,142219,192528,464429
5Fhj5Frt7b5YrfcdexdFw199JR7vCqj3DvH7V52vqfvuHbJg,0,0,40342,48160,66290,154792
5H64dC5Rg2tDjgTRjSPh6BCqoFa6wWNXdJ6PR5jk9xaeykMK,0,0,256292,274666,319089,850047
5HKqccBq8p96HNzQk5m7akuSoXFBRpGBQVQMPqAHRv8MXHT7,0,0,407901,421373,487175,1316449
5GZPKbnhn8Rt6axQx3jcyqbRxc1d7Lhra2Ajc7o8t63RUttX,0,0,285279,243431,0,528710
5HWcpuDMecwtvHLY2WSuZgZdn1TzHTjGtdYFM8i4E8Jznxt9,0,0,93275,0,0,93275
5EXcqFm4vGnVn17sKoxmqByHqepi6equHsxhwHJvPp2CGJ4m,0,0,93275,0,0,93275
5DjyaPBDs5homHD2s6KXN3GweyTLxcGyCyJpHxZZcuJj37yZ,0,0,93275,0,0,93275
5DLk7t1LUc3CeAQAuGz5fNqqtTqWCnwurjRhpDn3mbFikdmV,0,0,158655,129961,162003,450619
5FqExR2Gdj6JzBqGnq5XnxsGomzg6xwhuhUy44qiuXU6bdRs,0,0,9258,8593,8458,26309
5HZHiGWusJPQ5Fh9djtRH9TNmDWLmVW9NCFGkyvzooEAo86G,0,0,61396,34472,52880,148748
5HEEhsRBWuQLeJWgDoGHKYL2TP3u8JCwp9UYEj7vCrBXF449,0,0,1054275,2039444,2836201,5929920
5H3Kn4s5Jh6tnSogWFMZTmMD66tven5qct3UKQhUCD8vBjao,0,0,768251,677254,865408,2310913
5GudmjKXp71GorXM33yp9BWccBFwUZ2JQVA86HjcqFQpgqc5,0,0,180067,194756,258971,633794
5HdLt7b26XQ2BLM5DGVRyqDQAPxFwwHTzFvYyTXyPXoXtD2s,0,0,194072,209904,279113,683089
5E2TFP3Ha9tckGbPXzxrzShFTyWuVe4VyADgc7eS3LFHJaot,0,0,0,909404,1222434,2131838
5C4j5uwph4NTprBMCGwJs9ZD1xUFsnhg8vShNAGiAGHJ8LhF,0,0,0,19069,24342,43411
5GCZzxf1h1eXhCJQXzKQZacmGeYa9iWgKH5n8rSeL7QsGt9G,0,0,0,2618090,3187166,5805256
5GQqyeWm1f2eHyBKQARDYGNKxcam3wdJAQkGtbfoNUaaJaAU,0,0,0,92046,123534,215580
5Fk7SfEgwT5dGm3uqhXhessa6pcgtkWmmPFELxbjdpbYPUso,0,0,0,92046,0,92046
5E7Spsqx1qpeVsjpQoPvXLFztUsLekU4ZtM1Jm9d59DQptat,0,0,0,24360,29874,54234
5FhTeMQ9Z4QTP42LNhJn9pVBjmHRkWZhbMnTDoaV1q8XW48b,0,0,0,971166,1314706,2285872
5DPcccthVk9Tr5FdhT14QQQ3Sj1eTLErHQ3Yct4qGEQWYNN5,0,0,0,72856,88675,161531
5GvJupBxaCyHaNBBNYKNqPWimboMWdDuJ67E2BTWZxndRhuf,0,0,0,49769,66006,115775
5GixAyESbVRcTtoFUNf35rLfDSoEe1EWyJ9PytTRe4ieGqPn,0,0,0,361761,440618,802379
5HTa7qXDy5FixETz8LBeJ7diwz7bajz9RTv8HnL6y5KV23Vt,0,0,0,84458,0,84458
5F48C4BYhHp8z3GcXSoAaSFKh2N433HJcx9KHa7NBAgmc3bx,0,0,0,3740,8886,12626
